group;id;chrom;nSNP;from;to;lengthBps
Jacobs;H114;2;54;2451471;4835268;2383797
Jacobs;H114;2;31;5986185;7490500;1504315
Jacobs;H114;2;146;22109813;30849683;8739870
Jacobs;H114;2;43;35582012;38602691;3020679
Jacobs;H114;2;16;53991275;54669270;677995
Jacobs;H114;2;103;79017511;84802665;5785154
Jacobs;H114;2;74;84938566;88789712;3851146
Jacobs;H114;2;316;101320194;121484489;20164295
Jacobs;H114;2;20;122060498;123528595;1468097
Jacobs;H114;2;22;133402369;134770618;1368249
Jacobs;H114;2;27;145994402;147821995;1827593
Jacobs;H114;2;16;215498705;217457102;1958397
Jacobs;H114;2;95;229248722;234947844;5699122
Jacobs;H114;24;17;96467;1377045;1280578
Jacobs;H114;24;16;11076801;12335936;1259135
Jacobs;H115;2;50;1906939;4351718;2444779
Jacobs;H115;2;16;53991275;54669270;677995
Jacobs;H115;2;217;56039866;67126344;11086478
Jacobs;H115;2;63;72875158;76627899;3752741
Jacobs;H115;2;74;84640849;88553200;3912351
Jacobs;H115;2;128;96566325;104101891;7535566
Jacobs;H115;2;24;118134501;119654696;1520195
Jacobs;H115;2;17;122060498;123432784;1372286
Jacobs;H115;2;36;130606432;132323750;1717318
Jacobs;H115;2;35;140158515;141971484;1812969
Jacobs;H115;2;22;154579541;155797260;1217719
Jacobs;H115;2;77;167901271;172311083;4409812
Jacobs;H115;2;16;215498705;217457102;1958397
Jacobs;H115;2;16;217890987;219015064;1124077
Jacobs;H115;2;21;220083076;221216169;1133093
Jacobs;H115;2;85;244012987;248799264;4786277
Jacobs;H115;24;68;26493858;31556086;5062228
Jacobs;H116;2;25;1717596;2877210;1159614
Jacobs;H116;2;32;51824098;53366034;1541936
Jacobs;H116;2;48;55946911;58102980;2156069
Jacobs;H116;2;28;65402955;67012655;1609700
Jacobs;H116;2;57;79017511;81785728;2768217
Jacobs;H116;2;87;84069275;88789712;4720437
Jacobs;H116;2;15;94981400;95731895;750495
Jacobs;H116;2;192;103331488;116465257;13133769
Jacobs;H116;2;20;122060498;123528595;1468097
Jacobs;H116;2;38;125343919;127088467;1744548
Jacobs;H116;2;27;127495017;129045322;1550305
Jacobs;H116;2;31;155026089;156678409;1652320
Jacobs;H116;2;16;157252102;158187310;935208
Jacobs;H116;2;20;198155571;199020889;865318
Jacobs;H116;2;42;199225518;201797379;2571861
Jacobs;H116;2;227;202088645;215251657;13163012
Jacobs;H116;24;96;29375887;35991517;6615630
Jacobs;H26;2;15;5940814;6740866;800052
Jacobs;H26;2;100;10782174;16096373;5314199
Jacobs;H26;2;16;53991275;54669270;677995
Jacobs;H26;2;112;68216266;74824143;6607877
Jacobs;H26;2;54;84938566;87916949;2978383
Jacobs;H26;2;44;91063757;93513090;2449333
Jacobs;H26;2;54;118497369;121330712;2833343
Jacobs;H26;2;28;121455578;123432784;1977206
Jacobs;H26;2;16;133402369;134244380;842011
Jacobs;H26;2;33;138618372;140273577;1655205
Jacobs;H26;2;61;141007423;144457580;3450157
Jacobs;H26;2;34;205244432;207231826;1987394
Jacobs;H26;2;39;212342465;215251657;2909192
Jacobs;H26;2;50;216032030;220852308;4820278
Jacobs;H26;2;20;226617529;227734587;1117058
Jacobs;H26;2;43;231170715;233623788;2453073
Jacobs;H26;24;69;16351007;22222030;5871023
Jacobs;H26;24;26;24776080;26681408;1905328
Jacobs;H32;2;18;158066;1625350;1467284
Jacobs;H32;2;90;1675016;6092514;4417498
Jacobs;H32;2;60;8218127;11400715;3182588
Jacobs;H32;2;21;114411448;115743360;1331912
Jacobs;H32;2;15;116108127;117115355;1007228
Jacobs;H32;2;28;121590788;123528595;1937807
Jacobs;H32;2;53;135178922;138159566;2980644
Jacobs;H32;2;23;152529090;154052685;1523595
Jacobs;H32;24;31;17307132;19741398;2434266
Jacobs;H32;24;19;24776080;25961188;1185108
Navajo-Churro;H38;2;15;54086367;54687816;601449
Navajo-Churro;H38;2;15;113113775;114558942;1445167
Navajo-Churro;H38;2;21;131682707;132526868;844161
Navajo-Churro;H38;2;19;166996675;167955730;959055
Navajo-Churro;H38;24;16;1938133;3031957;1093824
Navajo-Churro;H44;2;55;53837176;56521561;2684385
Navajo-Churro;H44;2;15;113113775;114558942;1445167
Navajo-Churro;H44;2;17;148274554;149186801;912247
Navajo-Churro;H44;2;661;160549720;199498132;38948412
Navajo-Churro;H44;2;19;234269471;235184763;915292
Navajo-Churro;H56;2;74;158066;4370486;4212420
Navajo-Churro;H56;2;172;86057456;95965733;9908277
Navajo-Churro;H56;2;15;113113775;114558942;1445167
Navajo-Churro;H56;2;18;178045098;179079150;1034052
Navajo-Churro;H56;2;98;210045166;216807667;6762501
Jacobs;H50;2;22;6349125;7490500;1141375
Jacobs;H50;2;52;7727437;10649928;2922491
Jacobs;H50;2;19;30109974;31144311;1034337
Jacobs;H50;2;73;55415073;58791324;3376251
Jacobs;H50;2;20;65402955;66543498;1140543
Jacobs;H50;2;90;70802060;76075819;5273759
Jacobs;H50;2;94;92631842;98008059;5376217
Jacobs;H50;2;360;98817919;121330712;22512793
Jacobs;H50;2;20;122001925;123494681;1492756
Jacobs;H50;2;31;128510347;130206119;1695772
Jacobs;H50;2;16;131727936;132323750;595814
Jacobs;H50;2;24;136745970;138081646;1335676
Jacobs;H50;2;407;176765339;201496886;24731547
Jacobs;H50;2;72;230657435;234947844;4290409
Jacobs;H50;24;27;4000350;5874652;1874302
Jacobs;H50;24;29;5978910;7615311;1636401
Jacobs;H50;24;22;7721963;8842899;1120936
Jacobs;H50;24;164;12065734;24690825;12625091
Jacobs;H50;24;17;32598869;33503397;904528
Jacobs;H27;2;395;158066;21690410;21532344
Jacobs;H27;2;32;68216266;69880623;1664357
Jacobs;H27;2;130;84640849;92162531;7521682
Jacobs;H27;2;72;96566325;100951258;4384933
Jacobs;H27;2;17;122060498;123432784;1372286
Jacobs;H27;2;44;131727936;133577022;1849086
Jacobs;H27;2;42;186306661;188785740;2479079
Jacobs;H27;2;115;189799453;196397256;6597803
Jacobs;H27;2;163;209050239;220852308;11802069
Jacobs;H27;2;17;227127050;228074336;947286
Jacobs;H27;24;62;15510478;20406106;4895628
Navajo-Churro;H33;2;23;23460849;24646366;1185517
Navajo-Churro;H33;2;21;69880623;71218360;1337737
Navajo-Churro;H33;2;21;99399983;100718159;1318176
Navajo-Churro;H33;2;20;107258684;107989499;730815
Navajo-Churro;H33;2;17;108264568;108954373;689805
Navajo-Churro;H33;2;278;116992107;132056189;15064082
Navajo-Churro;H33;2;16;134301618;135178922;877304
Navajo-Churro;H33;2;19;141192562;142123229;930667
Navajo-Churro;H33;2;15;149539226;150249776;710550
Navajo-Churro;H33;2;21;182124730;183164212;1039482
Navajo-Churro;H33;2;16;215680487;217719922;2039435
Navajo-Churro;H33;2;35;223856449;225533687;1677238
Navajo-Churro;H33;24;28;32623905;34113252;1489347
Navajo-Churro;H39;2;25;14359717;15424986;1065269
Navajo-Churro;H39;2;330;75848139;94525031;18676892
Navajo-Churro;H39;2;15;102804384;103629915;825531
Navajo-Churro;H39;2;229;105702129;120634348;14932219
Navajo-Churro;H39;2;16;121515740;122429181;913441
Navajo-Churro;H39;2;17;189799453;190643587;844134
Navajo-Churro;H39;2;18;223762044;224527713;765669
Navajo-Churro;H45;2;440;158066;23881589;23723523
Navajo-Churro;H45;2;16;71387561;72284971;897410
Navajo-Churro;H45;2;15;80376822;80942245;565423
Navajo-Churro;H45;2;65;92162531;95965733;3803202
Navajo-Churro;H45;2;15;153972547;154723424;750877
Navajo-Churro;H45;2;16;159278703;160185941;907238
Navajo-Churro;H45;2;34;228977129;230789586;1812457
Navajo-Churro;H45;24;16;9658771;11232313;1573542
Navajo-Churro;H45;24;16;20734455;21910840;1176385
Navajo-Churro;H45;24;19;22329952;23689555;1359603
Navajo-Churro;H45;24;16;25614223;26759068;1144845
Navajo-Churro;H45;24;17;36938439;37753985;815546
Jacobs;H51;2;82;158066;4697573;4539507
Jacobs;H51;2;96;7672558;13078663;5406105
Jacobs;H51;2;24;17033754;18083119;1049365
Jacobs;H51;2;27;22809937;24092677;1282740
Jacobs;H51;2;79;24839164;29960448;5121284
Jacobs;H51;2;33;51824098;53415584;1591486
Jacobs;H51;2;16;53991275;54669270;677995
Jacobs;H51;2;28;54687816;56154368;1466552
Jacobs;H51;2;125;59972946;66543498;6570552
Jacobs;H51;2;17;70802060;71793127;991067
Jacobs;H51;2;20;107171359;107911874;740515
Jacobs;H51;2;16;108309773;108954373;644600
Jacobs;H51;2;19;121796989;123432784;1635795
Jacobs;H51;2;47;132841528;135391568;2550040
Jacobs;H51;2;24;136745970;138081646;1335676
Jacobs;H51;2;87;142676162;147996276;5320114
Jacobs;H51;2;21;159437585;160694589;1257004
Jacobs;H51;2;246;186306661;200658492;14351831
Jacobs;H51;2;15;205305554;206180550;874996
Jacobs;H51;2;178;208232368;220903491;12671123
Jacobs;H51;2;23;221624187;222800960;1176773
Jacobs;H51;2;52;233377856;235857471;2479615
Jacobs;H51;24;134;12036238;22329952;10293714
Jacobs;H57;2;50;1906939;4351718;2444779
Jacobs;H57;2;514;39586061;68412890;28826829
Jacobs;H57;2;211;91143985;103407822;12263837
Jacobs;H57;2;118;140655290;147650770;6995480
Jacobs;H57;2;126;199432096;206180550;6748454
Jacobs;H57;2;25;209050239;210418618;1368379
Jacobs;H57;2;28;215844761;219015064;3170303
Jacobs;H57;24;94;17040364;24629625;7589261
Jacobs;H57;24;115;33313461;42027686;8714225
Navajo-Churro;H28;2;70;80904183;84938566;4034383
Navajo-Churro;H28;2;17;103778735;104876321;1097586
Navajo-Churro;H28;2;26;108235636;109487038;1251402
Navajo-Churro;H28;2;22;129537914;130831021;1293107
Navajo-Churro;H28;2;22;148479250;149505811;1026561
Navajo-Churro;H28;2;35;238249575;240012290;1762715
Navajo-Churro;H34;2;68;14272947;17733005;3460058
Navajo-Churro;H34;2;168;17834999;26807018;8972019
Navajo-Churro;H34;2;292;75799552;92095417;16295865
Navajo-Churro;H34;2;65;92162531;95965733;3803202
Navajo-Churro;H34;2;217;160549720;172424726;11875006
Navajo-Churro;H34;2;168;172516697;183252529;10735832
Navajo-Churro;H34;2;71;183389553;187836750;4447197
Navajo-Churro;H34;2;136;187916592;195861753;7945161
Navajo-Churro;H34;2;23;202249334;203171974;922640
Navajo-Churro;H34;2;79;236398303;241057841;4659538
Navajo-Churro;H34;2;30;241298301;243050370;1752069
Jacobs;H40;2;23;158066;1815412;1657346
Jacobs;H40;2;16;53991275;54669270;677995
Jacobs;H40;2;81;70802060;75644823;4842763
Jacobs;H40;2;217;103466624;117835621;14368997
Jacobs;H40;2;165;118099428;127070041;8970613
Jacobs;H40;2;132;133402369;140897169;7494800
Jacobs;H40;2;193;193176635;203989901;10813266
Jacobs;H40;2;15;205305554;206180550;874996
Jacobs;H40;2;46;212342465;215498705;3156240
Jacobs;H40;2;162;216032030;226569909;10537879
Jacobs;H40;2;15;232591652;233589543;997891
Jacobs;H40;24;106;5485098;12550566;7065468
Jacobs;H40;24;62;17040364;21910840;4870476
Jacobs;H40;24;17;40336394;42027686;1691292
Jacobs;H46;2;50;1906939;4351718;2444779
Jacobs;H46;2;75;4431496;8561759;4130263
Jacobs;H46;2;27;22809937;24092677;1282740
Jacobs;H46;2;88;24839164;30589213;5750049
Jacobs;H46;2;38;46219946;48824104;2604158
Jacobs;H46;2;82;53366034;57495366;4129332
Jacobs;H46;2;42;89567061;92132718;2565657
Jacobs;H46;2;27;93217367;94609125;1391758
Jacobs;H46;2;20;122060498;123528595;1468097
Jacobs;H46;2;56;131165894;133748186;2582292
Jacobs;H46;2;15;134667278;135391568;724290
Jacobs;H46;2;118;140655290;147650770;6995480
Jacobs;H46;2;30;215774413;219015064;3240651
Jacobs;H46;2;15;220083076;220955491;872415
Jacobs;H46;24;61;5485098;8842899;3357801
Jacobs;H46;24;49;17996334;22222030;4225696
Jacobs;H46;24;20;33313461;34176391;862930
Jacobs;H46;24;15;39300789;40256403;955614
Navajo-Churro;H52;2;23;50949347;52327990;1378643
Navajo-Churro;H52;2;17;80304321;80942245;637924
Navajo-Churro;H52;2;23;113664053;115525483;1861430
Navajo-Churro;H52;2;16;132526868;133133629;606761
Navajo-Churro;H52;2;16;218592494;219933911;1341417
Navajo-Churro;H58;2;17;110228019;111172962;944943
Navajo-Churro;H29;2;38;11728531;13794213;2065682
Navajo-Churro;H29;2;18;33837135;34792034;954899
Navajo-Churro;H29;2;20;63770877;64622544;851667
Navajo-Churro;H29;2;20;67534697;68553052;1018355
Navajo-Churro;H29;2;24;86669812;87879884;1210072
Navajo-Churro;H29;2;35;107745785;109487038;1741253
Navajo-Churro;H29;2;19;116465257;117413762;948505
Navajo-Churro;H29;2;55;187836750;190978310;3141560
Navajo-Churro;H29;24;107;21629724;29910952;8281228
Jacobs;H35;2;16;10266961;10887825;620864
Jacobs;H35;2;18;39411236;40350901;939665
Jacobs;H35;2;33;42499181;44430836;1931655
Jacobs;H35;2;152;49169218;57182355;8013137
Jacobs;H35;2;78;70946621;75644823;4698202
Jacobs;H35;2;38;84069275;86380895;2311620
Jacobs;H35;2;29;91143985;92891269;1747284
Jacobs;H35;2;18;112551575;114279784;1728209
Jacobs;H35;2;66;122001925;125776688;3774763
Jacobs;H35;2;71;136336816;140273577;3936761
Jacobs;H35;2;45;141299872;143864562;2564690
Jacobs;H35;2;32;145745763;147821995;2076232
Jacobs;H35;2;21;159437585;160694589;1257004
Jacobs;H35;2;192;207575434;220852308;13276874
Jacobs;H35;2;17;227127050;228074336;947286
Jacobs;H35;2;72;228485892;232485668;3999776
Jacobs;H35;2;260;232554453;247635266;15080813
Jacobs;H35;24;48;96467;4116377;4019910
Jacobs;H35;24;25;7564606;8842899;1278293
Jacobs;H35;24;18;30412150;31568788;1156638
Navajo-Churro;H41;2;30;12636461;14159758;1523297
Navajo-Churro;H41;2;323;66226023;84640849;18414826
Navajo-Churro;H41;2;96;92631842;98270309;5638467
Navajo-Churro;H41;2;198;98483096;109731343;11248247
Navajo-Churro;H41;2;42;109829764;113916007;4086243
Navajo-Churro;H41;2;58;114224745;117573048;3348303
Navajo-Churro;H41;2;224;139597601;152203740;12606139
Navajo-Churro;H41;2;338;167955730;188979493;21023763
Navajo-Churro;H41;2;15;209901734;210708881;807147
Navajo-Churro;H41;2;21;236027912;237315458;1287546
Navajo-Churro;H41;24;95;962868;7615311;6652443
Navajo-Churro;H41;24;19;20442734;21878624;1435890
Jacobs;H47;2;79;6092514;10537097;4444583
Jacobs;H47;2;437;34792034;60044110;25252076
Jacobs;H47;2;265;60131740;75042274;14910534
Jacobs;H47;2;16;109766460;110765081;998621
Jacobs;H47;2;159;118099428;126734704;8635276
Jacobs;H47;2;111;206510663;212749665;6239002
Jacobs;H47;2;22;213790888;215641893;1851005
Jacobs;H47;24;17;96467;1377045;1280578
Jacobs;H47;24;17;7483090;8339627;856537
Jacobs;H47;24;24;8842899;10709974;1867075
Jacobs;H47;24;88;13558686;19741398;6182712
Navajo-Churro;H53;2;18;4008763;4739830;731067
Navajo-Churro;H53;2;18;6587778;7413337;825559
Navajo-Churro;H53;2;135;121455578;128762227;7306649
Navajo-Churro;H53;2;23;131596312;132526868;930556
Navajo-Churro;H53;2;19;144227691;145234800;1007109
Navajo-Churro;H53;2;16;148953266;149546970;593704
Navajo-Churro;H53;2;20;193596846;194853812;1256966
Navajo-Churro;H53;2;17;200160117;201345538;1185421
Navajo-Churro;H53;2;18;212793217;213756591;963374
Navajo-Churro;H53;2;86;231834142;236285593;4451451
Navajo-Churro;H53;2;20;238041313;239031909;990596
Navajo-Churro;H53;24;107;6647168;14275553;7628385
Navajo-Churro;H53;24;23;24989534;26759068;1769534
Jacobs;H59;2;88;158066;5039528;4881462
Jacobs;H59;2;119;16487040;22664271;6177231
Jacobs;H59;2;21;114411448;115743360;1331912
Jacobs;H59;2;15;116108127;117115355;1007228
Jacobs;H59;2;19;121590788;123048197;1457409
Jacobs;H59;2;38;131916165;133577022;1660857
Jacobs;H59;2;77;133655932;138159566;4503634
Jacobs;H59;2;23;152529090;154052685;1523595
Jacobs;H59;2;15;163564272;164349110;784838
Jacobs;H59;2;15;175790038;177011834;1221796
Jacobs;H59;2;45;182286302;184673171;2386869
Jacobs;H59;24;30;22222030;24493823;2271793
Navajo-Churro;H30;2;15;52924011;53725483;801472
Navajo-Churro;H30;2;205;86333486;98682513;12349027
Navajo-Churro;H30;2;339;98817919;120426576;21608657
Navajo-Churro;H30;2;16;218592494;219933911;1341417
Navajo-Churro;H30;2;15;240647987;241506698;858711
Navajo-Churro;H30;24;16;26068027;27620251;1552224
Navajo-Churro;H42;2;17;30173541;31018254;844713
Navajo-Churro;H42;2;60;67927937;71490850;3562913
Navajo-Churro;H42;2;18;183793517;184813524;1020007
Navajo-Churro;H42;2;193;220702849;230748446;10045597
Jacobs;H48;2;15;5940814;6740866;800052
Jacobs;H48;2;75;10782174;14827510;4045336
Jacobs;H48;2;68;67597692;71671999;4074307
Jacobs;H48;2;145;92213984;100951258;8737274
Jacobs;H48;2;17;122060498;123432784;1372286
Jacobs;H48;2;29;139520902;140897169;1376267
Jacobs;H48;2;31;142593638;144457580;1863942
Jacobs;H48;2;16;172745053;173584797;839744
Jacobs;H48;2;39;176369323;178764936;2395613
Jacobs;H48;2;111;193176635;199777656;6601021
Jacobs;H48;2;18;211611196;212749665;1138469
Jacobs;H48;2;23;231170715;232414241;1243526
Jacobs;H48;24;38;10176168;13558686;3382518
Jacobs;H48;24;78;15510478;21629724;6119246
Jacobs;H48;24;23;28037384;29475441;1438057
Jacobs;H54;2;28;10782174;12330936;1548762
Jacobs;H54;2;15;25850068;26807018;956950
Jacobs;H54;2;35;39240476;41530444;2289968
Jacobs;H54;2;24;74785937;76075819;1289882
Jacobs;H54;2;26;90945684;92132718;1187034
Jacobs;H54;2;20;107171359;107911874;740515
Jacobs;H54;2;16;108309773;108954373;644600
Jacobs;H54;2;19;121796989;123432784;1635795
Jacobs;H54;2;37;126734704;128762227;2027523
Jacobs;H54;2;30;142709866;144532167;1822301
Jacobs;H54;2;25;153765602;155158608;1393006
Jacobs;H54;2;256;186306661;201153924;14847263
Jacobs;H54;2;58;214020092;219694019;5673927
Jacobs;H54;2;17;227127050;228074336;947286
Jacobs;H54;24;19;4936555;6001198;1064643
Jacobs;H54;24;133;13231049;23418622;10187573
Jacobs;H54;24;185;26493858;39711452;13217594
Navajo-Churro;H60;2;55;53837176;56521561;2684385
Navajo-Churro;H60;2;67;77547185;80811295;3264110
Navajo-Churro;H60;2;779;84580673;131210129;46629456
Navajo-Churro;H60;2;22;171889296;172917684;1028388
Navajo-Churro;H60;2;22;197468568;198563117;1094549
Navajo-Churro;H60;2;191;230823473;241649475;10826002
Navajo-Churro;H60;24;69;16351007;22222030;5871023
Navajo-Churro;H60;24;18;26068027;27739247;1671220
Navajo-Churro;H31;2;54;48537833;51529698;2991865
Navajo-Churro;H31;2;21;73828642;74945550;1116908
Navajo-Churro;H31;2;15;113113775;114558942;1445167
Navajo-Churro;H31;2;15;229965518;230789586;824068
Navajo-Churro;H37;2;16;2157185;2756505;599320
Navajo-Churro;H37;2;18;6740866;7490500;749634
Navajo-Churro;H37;2;64;43260410;46912545;3652135
Navajo-Churro;H37;2;21;73828642;74945550;1116908
Navajo-Churro;H37;2;15;113113775;114558942;1445167
Navajo-Churro;H37;2;23;132289224;133229013;939789
Navajo-Churro;H37;2;17;244212834;245030239;817405
Navajo-Churro;H43;2;17;148274554;149186801;912247
Navajo-Churro;H43;2;1119;160549720;226958743;66409023
Navajo-Churro;H49;2;18;6587778;7413337;825559
Navajo-Churro;H49;2;18;63770877;64542824;771947
Navajo-Churro;H49;2;16;66608553;67488344;879791
Navajo-Churro;H49;2;16;108264568;108906253;641685
Navajo-Churro;H49;2;15;121734938;123048197;1313259
Navajo-Churro;H49;2;16;125030378;125571722;541344
Navajo-Churro;H49;2;98;210045166;216807667;6762501
Navajo-Churro;H49;2;17;244212834;245030239;817405
Navajo-Churro;H49;24;77;7107585;12550566;5442981
Jacobs;H55;2;19;5039528;5986185;946657
Jacobs;H55;2;137;43184130;51529698;8345568
Jacobs;H55;2;16;53991275;54669270;677995
Jacobs;H55;2;20;65402955;66543498;1140543
Jacobs;H55;2;32;68216266;69880623;1664357
Jacobs;H55;2;34;72790181;74824143;2033962
Jacobs;H55;2;96;77293547;81785728;4492181
Jacobs;H55;2;73;92162531;96330247;4167716
Jacobs;H55;2;20;122060498;123528595;1468097
Jacobs;H55;2;65;139163515;142506224;3342709
Jacobs;H55;2;35;157010221;159278703;2268482
Jacobs;H55;2;130;165546958;172917684;7370726
Jacobs;H55;2;19;242462366;243302892;840526
Jacobs;H55;24;67;12722014;17307132;4585118
Jacobs;H55;24;36;17996334;20918106;2921772
Jacobs;H55;24;18;33397677;34176391;778714
Navajo-Churro;H1;2;36;71434200;73475221;2041021
Navajo-Churro;H1;2;67;77547185;80811295;3264110
Navajo-Churro;H1;2;69;84580673;88218618;3637945
Navajo-Churro;H1;2;16;148953266;149546970;593704
Navajo-Churro;H1;2;15;198495174;199110298;615124
Navajo-Churro;H1;2;36;202088645;203751286;1662641
Navajo-Churro;H1;24;18;26068027;27739247;1671220
Navajo-Churro;H9;2;81;9792510;13932966;4140456
Navajo-Churro;H9;2;1498;29912263;117934792;88022529
Navajo-Churro;H9;2;19;131793590;132550706;757116
Navajo-Churro;H9;2;124;151200968;158665480;7464512
Navajo-Churro;H9;2;229;178922457;192869029;13946572
Navajo-Churro;H9;2;110;236541718;243221593;6679875
Navajo-Churro;H9;24;40;29652597;32390507;2737910
Jacobs;H17;2;109;158066;6092514;5934448
Jacobs;H17;2;20;15581003;16743751;1162748
Jacobs;H17;2;81;70802060;75644823;4842763
Jacobs;H17;2;26;90945684;92132718;1187034
Jacobs;H17;2;20;107171359;107911874;740515
Jacobs;H17;2;16;108309773;108954373;644600
Jacobs;H17;2;21;121796989;123494681;1697692
Jacobs;H17;2;462;126734704;152437856;25703152
Jacobs;H17;2;21;159437585;160694589;1257004
Jacobs;H17;2;133;164250208;171858694;7608486
Jacobs;H17;2;44;186410235;189054231;2643996
Jacobs;H17;2;31;204997139;206643029;1645890
Jacobs;H17;2;18;211611196;212749665;1138469
Jacobs;H17;2;29;230789586;232414241;1624655
Jacobs;H17;2;16;233988816;234947844;959028
Jacobs;H17;2;52;240967385;244212834;3245449
Jacobs;H17;24;34;6265369;8224303;1958934
Jacobs;H17;24;31;17307132;19741398;2434266
Jacobs;H17;24;19;24776080;25961188;1185108
Jacobs;H17;24;23;28037384;29475441;1438057
Navajo-Churro;H2;2;31;45015658;46912545;1896887
Navajo-Churro;H2;2;439;60161996;84640849;24478853
Navajo-Churro;H2;2;18;103629915;104524885;894970
Navajo-Churro;H2;2;17;110228019;111172962;944943
Navajo-Churro;H2;2;20;113664053;115083516;1419463
Navajo-Churro;H2;2;99;220154626;225231192;5076566
Navajo-Churro;H2;2;74;230823473;235184763;4361290
Navajo-Churro;H2;2;18;235741975;236541718;799743
Navajo-Churro;H2;2;17;244212834;245030239;817405
Navajo-Churro;H2;24;18;32984246;33798780;814534
Navajo-Churro;H2;24;26;36962278;38459023;1496745
Navajo-Churro;H10;2;25;14359717;15424986;1065269
Navajo-Churro;H10;2;320;75848139;93890508;18042369
Navajo-Churro;H10;2;33;96439757;98682513;2242756
Navajo-Churro;H10;2;94;98817919;104016758;5198839
Navajo-Churro;H10;2;15;106521892;107171359;649467
Navajo-Churro;H10;2;17;108264568;108954373;689805
Navajo-Churro;H10;2;15;169129216;170000512;871296
Navajo-Churro;H10;2;17;199020889;199890020;869131
Navajo-Churro;H10;2;209;225312697;236562748;11250051
Navajo-Churro;H10;24;20;27739247;29155367;1416120
Navajo-Churro;H19;2;35;53837176;55493174;1655998
Navajo-Churro;H19;2;98;59972946;64886088;4913142
Navajo-Churro;H19;2;15;113113775;114558942;1445167
Navajo-Churro;H19;2;23;132289224;133229013;939789
Navajo-Churro;H19;2;17;147821995;148711192;889197
Navajo-Churro;H19;2;30;189470005;190978310;1508305
Navajo-Churro;H19;2;54;191910639;194853812;2943173
Navajo-Churro;H19;2;34;228977129;230789586;1812457
Navajo-Churro;H19;2;21;236027912;237315458;1287546
Navajo-Churro;H19;24;62;16351007;21554660;5203653
Navajo-Churro;H3;2;20;17073547;18001962;928415
Navajo-Churro;H3;2;15;54086367;54687816;601449
Navajo-Churro;H3;2;21;73828642;74945550;1116908
Navajo-Churro;H3;2;96;101388496;107325100;5936604
Navajo-Churro;H3;2;23;132289224;133229013;939789
Navajo-Churro;H3;2;65;158192547;162169519;3976972
Navajo-Churro;H3;2;19;204064678;205132747;1068069
Navajo-Churro;H11;2;65;9266747;12558695;3291948
Navajo-Churro;H11;2;16;12636461;13571895;935434
Navajo-Churro;H11;2;41;85508894;87640092;2131198
Navajo-Churro;H11;2;16;184760567;185974821;1214254
Navajo-Churro;H11;2;30;189470005;190978310;1508305
Navajo-Churro;H11;24;18;9658771;11366060;1707289
Navajo-Churro;H11;24;18;21836004;23312288;1476284
Navajo-Churro;H11;24;19;33313461;34113252;799791
Navajo-Churro;H11;24;15;34345815;35878194;1532379
Jacobs;H20;2;15;5940814;6740866;800052
Jacobs;H20;2;75;10782174;14827510;4045336
Jacobs;H20;2;31;38602691;40350901;1748210
Jacobs;H20;2;29;53415584;54744188;1328604
Jacobs;H20;2;74;58078003;61921092;3843089
Jacobs;H20;2;127;67597692;75042274;7444582
Jacobs;H20;2;104;75745623;80904183;5158560
Jacobs;H20;2;32;84640849;86380895;1740046
Jacobs;H20;2;22;91063757;92132718;1068961
Jacobs;H20;2;305;93217367;110875234;17657867
Jacobs;H20;2;71;110973427;117158936;6185509
Jacobs;H20;2;17;122060498;123432784;1372286
Jacobs;H20;2;35;133402369;135391568;1989199
Jacobs;H20;2;24;136745970;138081646;1335676
Jacobs;H20;2;15;165486783;166231789;745006
Jacobs;H20;2;115;180052852;187259707;7206855
Jacobs;H20;2;193;193176635;203989901;10813266
Jacobs;H20;2;50;216032030;220852308;4820278
Jacobs;H20;2;29;231170715;232688816;1518101
Jacobs;H20;2;27;247079021;248799264;1720243
Jacobs;H20;24;71;17996334;24060526;6064192
Jacobs;H20;24;17;24472703;25523363;1050660
Jacobs;H20;24;16;33780315;34666650;886335
Navajo-Churro;H4;2;25;14359717;15424986;1065269
Navajo-Churro;H4;2;18;88367759;89567061;1199302
Navajo-Churro;H4;2;15;110284541;111172962;888421
Navajo-Churro;H4;2;23;121607287;123362485;1755198
Navajo-Churro;H4;2;15;127390949;128292892;901943
Navajo-Churro;H4;2;16;178741258;179965972;1224714
Navajo-Churro;H4;24;20;27739247;29155367;1416120
Navajo-Churro;H12;2;80;25811615;31018254;5206639
Navajo-Churro;H12;2;308;67223689;84705740;17482051
Navajo-Churro;H12;2;419;95965733;122244312;26278579
Navajo-Churro;H12;2;82;123259113;127070041;3810928
Navajo-Churro;H12;2;30;189470005;190978310;1508305
Navajo-Churro;H12;2;54;191910639;194853812;2943173
Jacobs;H21;2;23;14914968;16096373;1181405
Jacobs;H21;2;16;18584559;19145768;561209
Jacobs;H21;2;18;39411236;40350901;939665
Jacobs;H21;2;33;42499181;44430836;1931655
Jacobs;H21;2;714;49169218;87916949;38747731
Jacobs;H21;2;29;91143985;92891269;1747284
Jacobs;H21;2;18;112551575;114279784;1728209
Jacobs;H21;2;21;121796989;123494681;1697692
Jacobs;H21;2;27;142863809;144457580;1593771
Jacobs;H21;2;21;155107453;156095039;987586
Jacobs;H21;2;15;158780390;159857007;1076617
Jacobs;H21;2;58;214020092;219694019;5673927
Jacobs;H21;2;18;220083076;221078667;995591
Jacobs;H21;2;50;226617529;229189424;2571895
Jacobs;H21;2;29;230789586;232414241;1624655
Jacobs;H21;2;48;233988816;236215993;2227177
Jacobs;H21;24;22;7721963;8842899;1120936
Jacobs;H21;24;346;12065734;37808477;25742743
Jacobs;H13;2;184;39586061;51106073;11520012
Jacobs;H13;2;451;70802060;96566325;25764265
Jacobs;H13;2;444;100753683;127495017;26741334
Jacobs;H13;2;32;178456524;180818063;2361539
Jacobs;H13;2;48;211611196;215251657;3640461
Jacobs;H13;2;52;215844761;220852308;5007547
Jacobs;H13;2;28;229721318;231242200;1520882
Jacobs;H13;2;30;232260867;234119904;1859037
Jacobs;H13;2;15;235225978;235723972;497994
Jacobs;H13;24;68;16351007;21910840;5559833
Jacobs;H13;24;20;22329952;23828331;1498379
Jacobs;H22;2;64;1645676;4697573;3051897
Jacobs;H22;2;43;11728531;14016254;2287723
Jacobs;H22;2;16;14914968;15581003;666035
Jacobs;H22;2;16;23963448;24839164;875716
Jacobs;H22;2;110;25709378;32570209;6860831
Jacobs;H22;2;32;68216266;69880623;1664357
Jacobs;H22;2;30;79298450;80904183;1605733
Jacobs;H22;2;68;92213984;96209271;3995287
Jacobs;H22;2;74;101183181;105984105;4800924
Jacobs;H22;2;243;117115355;130206119;13090764
Jacobs;H22;2;19;130606432;131649580;1043148
Jacobs;H22;2;29;149539226;151148561;1609335
Jacobs;H22;2;25;176369323;178045098;1675775
Jacobs;H22;2;17;178676541;179939993;1263452
Jacobs;H22;2;76;180052852;184673171;4620319
Jacobs;H22;2;48;196397256;198928938;2531682
Jacobs;H22;2;15;199020889;199777656;756767
Jacobs;H22;2;70;211611196;217457102;5845906
Jacobs;H22;2;54;222606287;225193189;2586902
Jacobs;H22;2;29;231170715;232688816;1518101
Jacobs;H22;24;76;12722014;17996334;5274320
Jacobs;H22;24;76;36076909;42027686;5950777
Navajo-Churro;H6;2;48;64622544;67387676;2765132
Navajo-Churro;H6;2;17;80304321;80942245;637924
Navajo-Churro;H6;2;15;105984105;106716452;732347
Navajo-Churro;H6;2;59;117795421;121231306;3435885
Navajo-Churro;H6;2;21;241839716;243050370;1210654
Navajo-Churro;H14;2;196;3603417;14159758;10556341
Navajo-Churro;H14;2;15;55995982;56751008;755026
Navajo-Churro;H14;2;19;107258684;107922518;663834
Navajo-Churro;H14;2;22;129537914;130831021;1293107
Navajo-Churro;H14;2;35;136336816;138159566;1822750
Navajo-Churro;H14;2;17;165941483;167111471;1169988
Navajo-Churro;H14;2;19;175418941;176765339;1346398
Navajo-Churro;H14;2;18;190937309;191673164;735855
Navajo-Churro;H14;2;21;193596846;194928608;1331762
Navajo-Churro;H14;24;21;21836004;23509895;1673891
Jacobs;H7;2;47;16416165;18878677;2462512
Jacobs;H7;2;31;18910726;20422624;1511898
Jacobs;H7;2;99;20514245;25709378;5195133
Jacobs;H7;2;60;30638836;33959555;3320719
Jacobs;H7;2;35;39411236;41597285;2186049
Jacobs;H7;2;29;53415584;54744188;1328604
Jacobs;H7;2;74;58078003;61921092;3843089
Jacobs;H7;2;127;67597692;75042274;7444582
Jacobs;H7;2;138;75745623;82706925;6961302
Jacobs;H7;2;38;84069275;86380895;2311620
Jacobs;H7;2;44;91063757;93513090;2449333
Jacobs;H7;2;164;117702396;126734704;9032308
Jacobs;H7;2;22;133402369;134770618;1368249
Jacobs;H7;2;97;134809036;140273577;5464541
Jacobs;H7;2;61;141007423;144457580;3450157
Jacobs;H7;2;89;199432096;203989901;4557805
Jacobs;H7;2;33;205305554;207231826;1926272
Jacobs;H7;2;26;216032030;219015064;2983034
Jacobs;H7;24;29;11127323;13558686;2431363
Jacobs;H7;24;56;16351007;20918106;4567099
Jacobs;H7;24;17;40336394;42027686;1691292
Navajo-Churro;H15;2;189;14272947;24005033;9732086
Navajo-Churro;H15;2;15;53797807;54365821;568014
Navajo-Churro;H15;2;172;56413369;64886088;8472719
Navajo-Churro;H15;2;483;92162531;122244312;30081781
Navajo-Churro;H15;2;372;123259113;142902297;19643184
Navajo-Churro;H15;2;19;144500078;145444039;943961
Navajo-Churro;H15;2;93;243302892;248799264;5496372
Navajo-Churro;H15;24;16;25614223;26759068;1144845
Navajo-Churro;H24;2;16;46045582;47312229;1266647
Navajo-Churro;H24;2;19;144500078;145444039;943961
Navajo-Churro;H24;2;19;175418941;176765339;1346398
Navajo-Churro;H24;2;15;189470005;190239376;769371
Navajo-Churro;H24;2;19;242532287;243365308;833021
Navajo-Churro;H24;24;19;20442734;21878624;1435890
Navajo-Churro;H8;2;15;1426911;2157185;730274
Navajo-Churro;H8;2;15;80376822;80942245;565423
Navajo-Churro;H8;2;17;103778735;104876321;1097586
Navajo-Churro;H8;2;26;108235636;109487038;1251402
Navajo-Churro;H8;2;22;129537914;130831021;1293107
Navajo-Churro;H8;2;22;148479250;149505811;1026561
Navajo-Churro;H8;2;16;218592494;219933911;1341417
Navajo-Churro;H8;24;58;5384735;8556294;3171559
Jacobs;H16;2;16;10266961;10887825;620864
Jacobs;H16;2;23;14914968;16096373;1181405
Jacobs;H16;2;16;18584559;19145768;561209
Jacobs;H16;2;35;39411236;41597285;2186049
Jacobs;H16;2;29;53415584;54744188;1328604
Jacobs;H16;2;74;58078003;61921092;3843089
Jacobs;H16;2;127;67597692;75042274;7444582
Jacobs;H16;2;138;75745623;82706925;6961302
Jacobs;H16;2;38;84069275;86380895;2311620
Jacobs;H16;2;44;91063757;93513090;2449333
Jacobs;H16;2;64;117702396;121330712;3628316
Jacobs;H16;2;16;122096448;123432784;1336336
Jacobs;H16;2;16;133402369;134244380;842011
Jacobs;H16;2;17;140158515;141007423;848908
Jacobs;H16;2;48;211611196;215251657;3640461
Jacobs;H16;2;52;215844761;220852308;5007547
Jacobs;H16;2;20;226617529;227734587;1117058
Jacobs;H16;2;23;231170715;232414241;1243526
Jacobs;H16;2;29;238940445;240477448;1537003
Jacobs;H16;24;17;5621749;6468168;846419
Jacobs;H16;24;69;16351007;22222030;5871023
Navajo-Churro;H25;2;25;9735180;10807181;1072001
Navajo-Churro;H25;2;26;21334859;22784701;1449842
Navajo-Churro;H25;2;22;34303557;35330121;1026564
Navajo-Churro;H25;2;39;52050037;54047306;1997269
Navajo-Churro;H25;2;17;80304321;80942245;637924
Navajo-Churro;H25;2;17;110228019;111172962;944943
Navajo-Churro;H25;2;17;209719454;210626872;907418
Navajo-Churro;H25;2;16;230439460;231340317;900857
Jacobs;H64;2;38;985851;2877210;1891359
Jacobs;H64;2;27;11979482;13473852;1494370
Jacobs;H64;2;21;25850068;27209958;1359890
Jacobs;H64;2;32;38506443;40269973;1763530
Jacobs;H64;2;16;53991275;54669270;677995
Jacobs;H64;2;81;70802060;75644823;4842763
Jacobs;H64;2;48;76843058;79120023;2276965
Jacobs;H64;2;135;80262318;87816239;7553921
Jacobs;H64;2;38;87879884;90395737;2515853
Jacobs;H64;2;15;94981400;95731895;750495
Jacobs;H64;2;21;96254860;97513382;1258522
Jacobs;H64;2;72;100147522;103910743;3763221
Jacobs;H64;2;25;131165894;132323750;1157856
Jacobs;H64;2;18;140104951;141007423;902472
Jacobs;H64;2;37;142250151;144457580;2207429
Jacobs;H64;2;40;165546958;167736523;2189565
Jacobs;H64;2;42;169088679;171585407;2496728
Jacobs;H64;2;27;198217868;199498132;1280264
Jacobs;H64;2;88;199606841;204064678;4457837
Jacobs;H64;2;51;211611196;215368972;3757776
Jacobs;H64;2;33;216032030;219694019;3661989
Jacobs;H64;2;37;241748973;244066362;2317389
Jacobs;H64;24;76;12722014;17996334;5274320
Jacobs;H64;24;25;33397677;34666650;1268973
Jacobs;H62;2;22;4835268;6003251;1167983
Jacobs;H62;2;27;8180894;9735180;1554286
Jacobs;H62;2;134;15581003;22664271;7083268
Jacobs;H62;2;72;67387676;71671999;4284323
Jacobs;H62;2;49;86164251;88553200;2388949
Jacobs;H62;2;47;131727936;133748186;2020250
Jacobs;H62;2;15;134667278;135391568;724290
Jacobs;H62;2;137;179521559;188204145;8682586
Jacobs;H62;24;73;12181694;17307132;5125438
Jacobs;H62;24;16;24925070;25961188;1036118
Jacobs;H62;24;23;28037384;29475441;1438057
Navajo-Churro;H63;2;17;110228019;111172962;944943
Navajo-Churro;H63;24;16;26068027;27620251;1552224
Jacobs;H118;2;23;20046763;21080059;1033296
Jacobs;H118;2;16;32268777;33138364;869587
Jacobs;H118;2;18;35582012;36544130;962118
Jacobs;H118;2;99;51529698;56556228;5026530
Jacobs;H118;2;45;79017511;81273844;2256333
Jacobs;H118;2;53;83214641;86380895;3166254
Jacobs;H118;2;233;102804384;118180362;15375978
Jacobs;H118;2;15;122301320;123494681;1193361
Jacobs;H118;2;36;133402369;135446006;2043637
Jacobs;H118;2;45;140158515;142506224;2347709
Jacobs;H118;2;22;178119127;179673400;1554273
Jacobs;H118;2;32;187856073;189839836;1983763
Jacobs;H118;2;26;189930696;191228738;1298042
Jacobs;H118;2;24;199110298;200554450;1444152
Jacobs;H118;2;27;203942104;205403175;1461071
Jacobs;H118;2;18;211611196;212749665;1138469
Jacobs;H118;2;70;215774413;221534982;5760569
Jacobs;H118;2;71;222552458;226044848;3492390
Jacobs;H118;2;72;233461442;237221424;3759982
Jacobs;H118;24;15;26493858;27739247;1245389
Jacobs;H119;2;109;158066;6092514;5934448
Jacobs;H119;2;30;13307050;14827510;1520460
Jacobs;H119;2;73;15581003;19404154;3823151
Jacobs;H119;2;86;29409606;34303557;4893951
Jacobs;H119;2;82;40790032;45739882;4949850
Jacobs;H119;2;97;58791324;63837976;5046652
Jacobs;H119;2;173;65962375;76411172;10448797
Jacobs;H119;2;39;80376822;82013700;1636878
Jacobs;H119;2;17;122060498;123432784;1372286
Jacobs;H119;2;16;134194138;135063522;869384
Jacobs;H119;2;28;162689295;164188754;1499459
Jacobs;H119;2;15;232591652;233589543;997891
Jacobs;H119;2;30;241748973;243449101;1700128
Jacobs;H120;2;86;29409606;34303557;4893951
Jacobs;H120;2;82;40790032;45739882;4949850
Jacobs;H120;2;41;58791324;60993141;2201817
Jacobs;H120;2;55;61036097;63837976;2801879
Jacobs;H120;2;252;65962375;80343267;14380892
Jacobs;H120;2;36;81968762;84368094;2399332
Jacobs;H120;2;16;94981400;95965733;984333
Jacobs;H120;2;16;115340878;116108127;767249
Jacobs;H120;2;15;116784013;117464089;680076
Jacobs;H120;2;17;122060498;123432784;1372286
Jacobs;H120;2;20;128843993;129602869;758876
Jacobs;H120;2;37;131397735;132967710;1569975
Jacobs;H120;2;34;141007423;142709866;1702443
Jacobs;H120;2;28;162689295;164188754;1499459
Jacobs;H120;2;15;232591652;233589543;997891
Jacobs;H120;2;21;241748973;243005095;1256122
Jacobs;H120;2;20;246478010;247455331;977321
Jacobs;H121;2;15;4370486;5039528;669042
Jacobs;H121;2;19;6625835;7490500;864665
Jacobs;H121;2;51;19038121;21756019;2717898
Jacobs;H121;2;28;29960448;31388914;1428466
Jacobs;H121;2;26;49646230;51384849;1738619
Jacobs;H121;2;17;69626926;70721438;1094512
Jacobs;H121;2;30;79298450;80904183;1605733
Jacobs;H121;2;53;82507056;85956091;3449035
Jacobs;H121;2;40;88147512;90977972;2830460
Jacobs;H121;2;34;91063757;93102704;2038947
Jacobs;H121;2;27;93217367;94609125;1391758
Jacobs;H121;2;20;107171359;107911874;740515
Jacobs;H121;2;16;108309773;108954373;644600
Jacobs;H121;2;19;121796989;123432784;1635795
Jacobs;H121;2;16;131793590;132391474;597884
Jacobs;H121;2;23;136632758;137832529;1199771
Jacobs;H121;2;15;156555652;157252102;696450
Jacobs;H121;2;22;198495174;199498132;1002958
Jacobs;H121;2;26;200554450;201951137;1396687
Jacobs;H121;2;121;223908949;230323317;6414368
Jacobs;H121;2;15;235225978;235723972;497994
Jacobs;H121;24;71;23828331;29155367;5327036
Jacobs;H122;2;75;985851;4697573;3711722
Jacobs;H122;2;24;14359717;15388156;1028439
Jacobs;H122;2;48;26664802;30026978;3362176
Jacobs;H122;2;63;54240741;57495366;3254625
Jacobs;H122;2;105;70548455;76783372;6234917
Jacobs;H122;2;38;84069275;86380895;2311620
Jacobs;H122;2;15;110083416;110941391;857975
Jacobs;H122;2;19;121796989;123432784;1635795
Jacobs;H122;2;24;127390949;128843993;1453044
Jacobs;H122;2;19;130606432;131649580;1043148
Jacobs;H122;2;21;132841528;133748186;906658
Jacobs;H122;2;16;215498705;217457102;1958397
Jacobs;H122;2;42;217890987;220955491;3064504
Jacobs;H122;2;45;221773273;224027318;2254045
Jacobs;H122;2;15;232591652;233589543;997891
Jacobs;H122;24;45;5874652;8314969;2440317
Jacobs;H122;24;67;24106007;29155367;5049360
Jacobs;H123;2;15;56556228;57307599;751371
Jacobs;H123;2;17;114224745;115476148;1251403
Jacobs;H123;2;17;122060498;123432784;1372286
Jacobs;H123;2;65;151148561;155126465;3977904
Jacobs;H123;2;20;168933988;170000512;1066524
Jacobs;H123;2;33;208020229;209765359;1745130
Jacobs;H123;2;78;209830001;214228529;4398528
Jacobs;H123;2;16;215498705;217457102;1958397
Jacobs;H123;24;44;11076801;14492312;3415511
Jacobs;H124;2;45;16487040;18878677;2391637
Jacobs;H124;2;21;26100485;27311358;1210873
Jacobs;H124;2;47;49646230;52641482;2995252
Jacobs;H124;2;61;52714676;55758208;3043532
Jacobs;H124;2;31;55908488;57376604;1468116
Jacobs;H124;2;38;57495366;59112309;1616943
Jacobs;H124;2;33;80904183;82633584;1729401
Jacobs;H124;2;20;92213984;93451281;1237297
Jacobs;H124;2;26;94894157;96439757;1545600
Jacobs;H124;2;25;101985195;103407822;1422627
Jacobs;H124;2;32;116500683;118365256;1864573
Jacobs;H124;2;118;118497369;125164918;6667549
Jacobs;H124;2;36;125261082;126802631;1541549
Jacobs;H124;2;33;129537914;131584922;2047008
Jacobs;H124;2;20;131649580;132391474;741894
Jacobs;H124;2;33;142863809;144672338;1808529
Jacobs;H124;2;60;157252102;161172554;3920452
Jacobs;H124;2;30;161335278;162572509;1237231
Jacobs;H124;2;15;205305554;206180550;874996
Jacobs;H124;2;132;208232368;217457102;9224734
Jacobs;H124;2;34;238041313;239775862;1734549
Jacobs;H125;2;22;44760451;45959888;1199437
Jacobs;H125;2;17;73046724;73926990;880266
Jacobs;H125;2;41;84069275;86582074;2512799
Jacobs;H125;2;20;107171359;107911874;740515
Jacobs;H125;2;16;108309773;108954373;644600
Jacobs;H125;2;19;121796989;123432784;1635795
Jacobs;H125;2;24;149768329;151200968;1432639
Jacobs;H125;2;36;162689295;164516447;1827152
Jacobs;H125;2;27;189117884;190643587;1525703
Jacobs;H125;2;34;200160117;202088645;1928528
Jacobs;H125;2;40;219357404;221633575;2276171
Jacobs;H125;2;121;223908949;230323317;6414368
Jacobs;H125;24;37;26493858;29343449;2849591
Jacobs;H125;24;18;30412150;31568788;1156638
Jacobs;H126;2;89;46598180;52218919;5620739
Jacobs;H126;2;18;53670410;54386685;716275
Jacobs;H126;2;70;80811295;84891847;4080552
Jacobs;H126;2;18;86266274;87138916;872642
Jacobs;H126;2;15;110083416;110941391;857975
Jacobs;H126;2;19;121796989;123432784;1635795
Jacobs;H126;2;34;133402369;135337045;1934676
Jacobs;H126;2;108;170058634;176450447;6391813
Jacobs;H126;2;85;186306661;191228738;4922077
Jacobs;H126;2;18;211611196;212749665;1138469
Jacobs;H126;2;22;213790888;215641893;1851005
Jacobs;H126;2;56;217890987;221534982;3643995
Jacobs;H126;2;33;222552458;224027318;1474860
Jacobs;H126;2;27;230439460;231931202;1491742
Jacobs;H126;24;40;29155367;31943864;2788497
Jacobs;H126;24;29;39603557;42027686;2424129
Jacobs;H127;2;30;4431496;5798140;1366644
Jacobs;H127;2;38;31712060;33959555;2247495
Jacobs;H127;2;16;45686718;46598180;911462
Jacobs;H127;2;45;54240741;56556228;2315487
Jacobs;H127;2;19;72875158;73926990;1051832
Jacobs;H127;2;30;79298450;80904183;1605733
Jacobs;H127;2;99;82507056;88172646;5665590
Jacobs;H127;2;20;107171359;107911874;740515
Jacobs;H127;2;16;108309773;108954373;644600
Jacobs;H127;2;19;121796989;123432784;1635795
Jacobs;H127;2;98;144342270;149720801;5378531
Jacobs;H127;2;108;170058634;176450447;6391813
Jacobs;H127;2;18;211611196;212749665;1138469
Jacobs;H127;2;22;213790888;215641893;1851005
Jacobs;H127;2;56;217890987;221534982;3643995
Jacobs;H127;2;33;222552458;224027318;1474860
Jacobs;H127;2;27;230439460;231931202;1491742
Jacobs;H127;2;27;238041313;239325418;1284105
Jacobs;H127;24;40;29155367;31943864;2788497
Jacobs;H127;24;24;39603557;41034970;1431413
Jacobs;H128;2;30;4431496;5798140;1366644
Jacobs;H128;2;38;31712060;33959555;2247495
Jacobs;H128;2;69;52266474;55758208;3491734
Jacobs;H128;2;70;55908488;59112309;3203821
Jacobs;H128;2;91;69626926;75042274;5415348
Jacobs;H128;2;112;75192672;80904183;5711511
Jacobs;H128;2;24;86266274;87415354;1149080
Jacobs;H128;2;15;110083416;110941391;857975
Jacobs;H128;2;16;122096448;123432784;1336336
Jacobs;H128;2;22;133402369;134770618;1368249
Jacobs;H128;2;20;168933988;170000512;1066524
Jacobs;H128;2;40;219357404;221633575;2276171
Jacobs;H128;2;96;223908949;229023952;5115003
Jacobs;H128;2;27;230439460;231931202;1491742
Jacobs;H128;2;44;238041313;240409281;2367968
Jacobs;H128;24;19;4116377;5433186;1316809
Jacobs;H128;24;80;25523363;31359697;5836334
Jacobs;H129;2;190;34376030;46219946;11843916
Jacobs;H129;2;16;53991275;54669270;677995
Jacobs;H129;2;15;56556228;57307599;751371
Jacobs;H129;2;1236;75799552;147821995;72022443
Jacobs;H129;2;367;148274554;169129216;20854662
Jacobs;H129;2;72;181909538;186224877;4315339
Jacobs;H129;2;16;215498705;217457102;1958397
Jacobs;H129;2;390;226569909;248799264;22229355
Jacobs;H129;24;17;11076801;12387404;1310603
Jacobs;H129;24;41;19946691;23418622;3471931
Jacobs;H130;2;36;1248985;2877210;1628225
Jacobs;H130;2;79;54240741;58102980;3862239
Jacobs;H130;2;20;65402955;66543498;1140543
Jacobs;H130;2;18;66858417;67763382;904965
Jacobs;H130;2;30;75674121;77293547;1619426
Jacobs;H130;2;30;79298450;80904183;1605733
Jacobs;H130;2;99;82507056;88172646;5665590
Jacobs;H130;2;15;110083416;110941391;857975
Jacobs;H130;2;19;121796989;123432784;1635795
Jacobs;H130;2;34;133402369;135337045;1934676
Jacobs;H130;2;19;142863809;143918492;1054683
Jacobs;H130;2;24;162513140;163845372;1332232
Jacobs;H130;2;17;165399749;166231789;832040
Jacobs;H130;2;101;170563260;176450447;5887187
Jacobs;H130;2;18;211611196;212749665;1138469
Jacobs;H130;2;22;213790888;215641893;1851005
Jacobs;H130;2;45;218592494;221534982;2942488
Jacobs;H130;2;33;222552458;224027318;1474860
Jacobs;H130;2;83;225936196;230323317;4387121
Jacobs;H130;24;40;29155367;31943864;2788497
Jacobs;H130;24;29;39603557;42027686;2424129
Jacobs;H131;2;16;10266961;10887825;620864
Jacobs;H131;2;57;31362675;34615665;3252990
Jacobs;H131;2;18;44538846;45357951;819105
Jacobs;H131;2;24;124443428;125352833;909405
Jacobs;H131;2;23;138618372;139800218;1181846
Jacobs;H131;2;15;139846639;140560157;713518
Jacobs;H131;2;36;184760567;187131720;2371153
Jacobs;H131;2;31;193318025;195245620;1927595
Jacobs;H131;2;20;195890936;197093416;1202480
Jacobs;H131;2;39;199432096;201797379;2365283
Jacobs;H131;2;48;211611196;215251657;3640461
Jacobs;H131;2;22;215844761;218418759;2573998
Jacobs;H131;2;30;241748973;243449101;1700128
Jacobs;H131;2;29;247005105;248799264;1794159
Jacobs;H131;24;17;12550566;13767641;1217075
Jacobs;H131;24;25;32984246;34176391;1192145
Jacobs;H131;24;24;36425274;38125663;1700389
Jacobs;H132;2;170;26664802;36871168;10206366
Jacobs;H132;2;77;36971592;42499181;5527589
Jacobs;H132;2;409;54240741;76627899;22387158
Jacobs;H132;2;16;79000514;80032995;1032481
Jacobs;H132;2;38;84069275;86380895;2311620
Jacobs;H132;2;16;115340878;116108127;767249
Jacobs;H132;2;15;116784013;117464089;680076
Jacobs;H132;2;17;122060498;123432784;1372286
Jacobs;H132;2;37;126802631;128843993;2041362
Jacobs;H132;2;19;130606432;131649580;1043148
Jacobs;H132;2;21;132841528;133748186;906658
Jacobs;H132;2;28;162689295;164188754;1499459
Jacobs;H132;2;33;204702992;206382108;1679116
Jacobs;H132;2;95;207575434;212749665;5174231
Jacobs;H132;2;37;213505877;217457102;3951225
Jacobs;H132;2;15;220083076;220955491;872415
Jacobs;H132;24;43;96467;3580800;3484333
Jacobs;H132;24;15;15637488;16892562;1255074
Jacobs;H132;24;16;31556086;32390507;834421
Jacobs;H133;2;56;158066;3489649;3331583
Jacobs;H133;2;182;15281005;24839164;9558159
Jacobs;H133;2;66;45658202;49646230;3988028
Jacobs;H133;2;32;51824098;53366034;1541936
Jacobs;H133;2;58;68216266;71671999;3455733
Jacobs;H133;2;56;95731895;99427585;3695690
Jacobs;H133;2;21;114411448;115743360;1331912
Jacobs;H133;2;15;116108127;117115355;1007228
Jacobs;H133;2;39;133402369;135536214;2133845
Jacobs;H133;2;70;140104951;143918492;3813541
Jacobs;H133;2;39;147759341;149609364;1850023
Jacobs;H133;2;161;179799000;189839836;10040836
Jacobs;H133;2;60;189930696;192989350;3058654
Jacobs;H133;2;55;193433380;197093416;3660036
Jacobs;H133;2;134;207040648;215251657;8211009
Jacobs;H133;2;35;215844761;219694019;3849258
Jacobs;H133;2;18;220083076;221078667;995591
Jacobs;H133;24;20;11127323;12722014;1594691
Jacobs;H133;24;68;27928201;32390507;4462306
Jacobs;H133;24;20;33313461;34176391;862930
Jacobs;H133;24;72;36425274;42027686;5602412
Jacobs;H134;2;25;25563222;27209958;1646736
Jacobs;H134;2;16;53991275;54669270;677995
Jacobs;H134;2;105;70548455;76783372;6234917
Jacobs;H134;2;16;94981400;95965733;984333
Jacobs;H134;2;16;115340878;116108127;767249
Jacobs;H134;2;15;116784013;117464089;680076
Jacobs;H134;2;17;122060498;123432784;1372286
Jacobs;H134;2;84;128843993;132967710;4123717
Jacobs;H134;2;22;171171929;172311083;1139154
Jacobs;H134;2;602;179521559;214228529;34706970
Jacobs;H134;2;16;215498705;217457102;1958397
Jacobs;H134;2;15;220083076;220955491;872415
Jacobs;H134;2;29;238940445;240477448;1537003
Jacobs;H134;24;23;203039;2191707;1988668
Jacobs;H134;24;34;26493858;29155367;2661509
Jacobs;H135;2;45;54240741;56556228;2315487
Jacobs;H135;2;39;80376822;82013700;1636878
Jacobs;H135;2;21;84580673;85875802;1295129
Jacobs;H135;2;17;100951258;101600940;649682
Jacobs;H135;2;18;116203332;117295185;1091853
Jacobs;H135;2;19;122060498;123494681;1434183
Jacobs;H135;2;15;135590631;136512593;921962
Jacobs;H135;2;40;147759341;149666645;1907304
Jacobs;H135;2;65;151148561;155126465;3977904
Jacobs;H135;2;39;172699752;175124550;2424798
Jacobs;H135;2;70;199432096;203129937;3697841
Jacobs;H135;2;44;203219228;205454966;2235738
Jacobs;H135;24;24;5232180;6526499;1294319
Jacobs;H135;24;72;11076801;16077497;5000696
Jacobs;H135;24;75;18056244;24493823;6437579
Jacobs;H135;24;61;31953567;36076909;4123342
Jacobs;H136;2;541;158066;30485387;30327321
Jacobs;H136;2;555;30589213;62416830;31827617
Jacobs;H136;2;17;91333600;92162531;828931
Jacobs;H136;2;44;99302002;101521231;2219229
Jacobs;H136;2;24;113897647;115665643;1767996
Jacobs;H136;2;17;122060498;123432784;1372286
Jacobs;H136;2;65;151148561;155126465;3977904
Jacobs;H136;2;72;181909538;186224877;4315339
Jacobs;H136;2;84;244066362;248799264;4732902
Jacobs;H136;24;19;2043961;3446498;1402537
Jacobs;H137;2;36;2451471;4166902;1715431
Jacobs;H137;2;25;25563222;27209958;1646736
Jacobs;H137;2;16;53991275;54669270;677995
Jacobs;H137;2;105;70548455;76783372;6234917
Jacobs;H137;2;27;82692589;84368094;1675505
Jacobs;H137;2;16;94981400;95965733;984333
Jacobs;H137;2;16;115340878;116108127;767249
Jacobs;H137;2;15;116784013;117464089;680076
Jacobs;H137;2;17;122060498;123432784;1372286
Jacobs;H137;2;84;128843993;132967710;4123717
Jacobs;H137;2;18;137024724;138081646;1056922
Jacobs;H137;2;37;141766599;143918492;2151893
Jacobs;H137;2;139;155064316;163070840;8006524
Jacobs;H137;2;606;182923305;219847222;36923917
Jacobs;H137;2;32;225936196;227734587;1798391
Jacobs;H137;2;15;232591652;233589543;997891
Jacobs;H137;2;30;241748973;243449101;1700128
Jacobs;H137;24;69;26493858;31568788;5074930
Jacobs;H138;2;50;2451471;4697573;2246102
Jacobs;H138;2;525;24839164;56556228;31717064
Jacobs;H138;2;19;121796989;123432784;1635795
Jacobs;H138;2;49;127699622;130206119;2506497
Jacobs;H138;2;34;133402369;135337045;1934676
Jacobs;H138;2;18;141766599;142709866;943267
Jacobs;H138;2;33;208020229;209765359;1745130
Jacobs;H138;2;78;209830001;214228529;4398528
Jacobs;H138;2;23;233775867;235161178;1385311
Jacobs;H138;24;55;5874652;8842899;2968247
Jacobs;H139;2;17;24646366;25359294;712928
Jacobs;H139;2;26;49646230;51384849;1738619
Jacobs;H139;2;20;65402955;66543498;1140543
Jacobs;H139;2;18;66858417;67763382;904965
Jacobs;H139;2;52;84069275;87138916;3069641
Jacobs;H139;2;15;110083416;110941391;857975
Jacobs;H139;2;19;121796989;123432784;1635795
Jacobs;H139;2;46;132841528;135337045;2495517
Jacobs;H139;2;24;149768329;151200968;1432639
Jacobs;H139;2;15;158290735;159437585;1146850
Jacobs;H139;2;70;187856073;191673164;3817091
Jacobs;H139;2;15;203751286;204502491;751205
Jacobs;H139;2;26;205305554;206821701;1516147
Jacobs;H139;2;18;211611196;212749665;1138469
Jacobs;H139;2;22;213790888;215641893;1851005
Jacobs;H139;2;56;217890987;221534982;3643995
Jacobs;H139;2;33;222552458;224027318;1474860
Jacobs;H139;2;83;225936196;230323317;4387121
Jacobs;H139;24;37;26493858;29343449;2849591
Jacobs;H139;24;31;29475441;31568788;2093347
Jacobs;H140;2;18;9735180;10487132;751952
Jacobs;H140;2;16;45150277;46163449;1013172
Jacobs;H140;2;27;47352919;49009193;1656274
Jacobs;H140;2;26;49646230;51384849;1738619
Jacobs;H140;2;28;68055389;69441272;1385883
Jacobs;H140;2;114;75674121;81377249;5703128
Jacobs;H140;2;26;81452694;82891061;1438367
Jacobs;H140;2;22;83090209;84368094;1277885
Jacobs;H140;2;51;94981400;98156393;3174993
Jacobs;H140;2;89;103049092;107989499;4940407
Jacobs;H140;2;130;108736660;118365256;9628596
Jacobs;H140;2;132;119388364;126384559;6996195
Jacobs;H140;2;25;140827873;142063966;1236093
Jacobs;H140;2;44;142192657;144672338;2479681
Jacobs;H140;2;18;211611196;212749665;1138469
Jacobs;H140;2;22;213790888;215641893;1851005
Jacobs;H140;2;59;217890987;221633575;3742588
Jacobs;H140;2;45;221773273;224027318;2254045
Jacobs;H140;2;15;232591652;233589543;997891
Jacobs;H140;2;22;247548978;248799264;1250286
Jacobs;H140;24;73;12181694;17307132;5125438
Jacobs;H141;2;26;6349125;7973431;1624306
Jacobs;H141;2;17;10782174;11555842;773668
Jacobs;H141;2;35;12988767;14827510;1838743
Jacobs;H141;2;48;26664802;30026978;3362176
Jacobs;H141;2;16;45150277;46163449;1013172
Jacobs;H141;2;30;46833373;49009193;2175820
Jacobs;H141;2;26;49646230;51384849;1738619
Jacobs;H141;2;25;55160910;56556228;1395318
Jacobs;H141;2;209;87177434;99808715;12631281
Jacobs;H141;2;142;99887361;107989499;8102138
Jacobs;H141;2;334;108072803;128843993;20771190
Jacobs;H141;2;34;133402369;135337045;1934676
Jacobs;H141;2;60;152529090;156095039;3565949
Jacobs;H141;2;20;176450447;177920217;1469770
Jacobs;H141;2;194;187856073;199020889;11164816
Jacobs;H141;2;45;238041313;240477448;2436135
Jacobs;H141;2;22;247548978;248799264;1250286
Jacobs;H141;24;36;29155367;31568788;2413421
Jacobs;H142;2;50;2451471;4697573;2246102
Jacobs;H142;2;28;24839164;26315932;1476768
Jacobs;H142;2;16;29409606;30280645;871039
Jacobs;H142;2;105;70548455;76783372;6234917
Jacobs;H142;2;20;122060498;123528595;1468097
Jacobs;H142;2;19;130606432;131649580;1043148
Jacobs;H142;2;25;149720801;151200968;1480167
Jacobs;H142;2;20;168933988;170000512;1066524
Jacobs;H142;2;335;172917684;193433380;20515696
Jacobs;H142;2;112;208020229;214228529;6208300
Jacobs;H142;2;29;238940445;240477448;1537003
Jacobs;H142;24;34;26493858;29155367;2661509
Jacobs;H143;2;20;19163821;20209570;1045749
Jacobs;H143;2;29;26100485;27784609;1684124
Jacobs;H143;2;17;65962375;67012655;1050280
Jacobs;H143;2;35;67625735;69441272;1815537
Jacobs;H143;2;87;116500683;121330712;4830029
Jacobs;H143;2;100;121455578;126802631;5347053
Jacobs;H143;2;54;129537914;132391474;2853560
Jacobs;H143;2;33;142863809;144672338;1808529
Jacobs;H143;2;275;157252102;172917684;15665582
Jacobs;H143;2;25;180080977;181909538;1828561
Jacobs;H143;2;30;215498705;218309332;2810627
Jacobs;H143;2;54;219933911;222800960;2867049
Jacobs;H143;24;17;26493858;28037384;1543526
Jacobs;H143;24;16;28178738;29155367;976629
Jacobs;H144;2;41;2451471;4351718;1900247
Jacobs;H144;2;45;54240741;56556228;2315487
Jacobs;H144;2;93;75626143;80343267;4717124
Jacobs;H144;2;74;85661724;89810015;4148291
Jacobs;H144;2;20;122060498;123528595;1468097
Jacobs;H144;2;38;125343919;127088467;1744548
Jacobs;H144;2;31;129353026;131064734;1711708
Jacobs;H144;2;40;131165894;132967710;1801816
Jacobs;H144;2;50;144088879;146734798;2645919
Jacobs;H144;2;139;155064316;163070840;8006524
Jacobs;H144;2;20;168933988;170000512;1066524
Jacobs;H144;2;43;215680487;219847222;4166735
Jacobs;H144;2;135;231170715;238675170;7504455
Jacobs;H144;24;43;96467;3580800;3484333
Jacobs;H145;2;41;2451471;4351718;1900247
Jacobs;H145;2;32;13507694;15035660;1527966
Jacobs;H145;2;61;16374818;19404154;3029336
Jacobs;H145;2;38;46219946;48824104;2604158
Jacobs;H145;2;30;60161996;61875935;1713939
Jacobs;H145;2;72;62820094;66543498;3723404
Jacobs;H145;2;32;69626926;71671999;2045073
Jacobs;H145;2;23;87394092;88447935;1053843
Jacobs;H145;2;15;108736660;109420304;683644
Jacobs;H145;2;21;116265153;117413762;1148609
Jacobs;H145;2;57;124171406;126734704;2563298
Jacobs;H145;2;22;127699622;128843993;1144371
Jacobs;H145;2;47;132841528;135391568;2550040
Jacobs;H145;2;24;136745970;138081646;1335676
Jacobs;H145;2;50;140158515;142709866;2551351
Jacobs;H145;2;22;215309338;217457102;2147764
Jacobs;H145;2;17;236347543;237488816;1141273
Jacobs;H145;24;17;96467;1377045;1280578
Jacobs;H146;2;41;2451471;4351718;1900247
Jacobs;H146;2;69;5094572;9266747;4172175
Jacobs;H146;2;255;16374818;30785949;14411131
Jacobs;H146;2;28;46833373;48824104;1990731
Jacobs;H146;2;74;51143878;54936988;3793110
Jacobs;H146;2;71;85242819;88789712;3546893
Jacobs;H146;2;63;95731895;99808715;4076820
Jacobs;H146;2;50;124171406;126384559;2213153
Jacobs;H146;2;47;132841528;135391568;2550040
Jacobs;H146;2;20;136745970;137781188;1035218
Jacobs;H146;2;26;157574569;159389044;1814475
Jacobs;H146;2;215;159513893;171398254;11884361
Jacobs;H146;2;56;184565642;188204145;3638503
Jacobs;H146;2;104;193433380;199626176;6192796
Jacobs;H146;2;134;207040648;215251657;8211009
Jacobs;H146;2;52;215844761;220852308;5007547
Jacobs;H146;2;23;247498052;248799264;1301212
Jacobs;H146;24;62;96467;5075204;4978737
Jacobs;H146;24;82;5621749;10802789;5181040
Jacobs;H146;24;22;11007102;12722014;1714912
Jacobs;H147;2;219;158066;12492887;12334821
Jacobs;H147;2;40;12988767;15035660;2046893
Jacobs;H147;2;15;16487040;17140743;653703
Jacobs;H147;2;58;36971592;40931803;3960211
Jacobs;H147;2;18;53670410;54386685;716275
Jacobs;H147;2;47;55908488;57989729;2081241
Jacobs;H147;2;180;58102980;67597692;9494712
Jacobs;H147;2;1102;67676280;132391474;64715194
Jacobs;H147;2;33;142863809;144672338;1808529
Jacobs;H147;2;59;167249075;170471855;3222780
Jacobs;H147;2;315;201153924;220955491;19801567
Jacobs;H147;2;89;243537018;248799264;5262246
Jacobs;H147;24;15;15367865;16310285;942420
Jacobs;H147;24;15;20395301;21460746;1065445
Jacobs;H147;24;36;29155367;31568788;2413421
Jacobs;H148;2;40;12988767;15035660;2046893
Jacobs;H148;2;15;16487040;17140743;653703
Jacobs;H148;2;375;34985894;57376604;22390710
Jacobs;H148;2;298;57495366;73598907;16103541
Jacobs;H148;2;52;84069275;87138916;3069641
Jacobs;H148;2;17;117702396;119081713;1379317
Jacobs;H148;2;19;121796989;123432784;1635795
Jacobs;H148;2;34;133402369;135337045;1934676
Jacobs;H148;2;61;148597613;151888029;3290416
Jacobs;H148;2;108;170058634;176450447;6391813
Jacobs;H148;2;18;211611196;212749665;1138469
Jacobs;H148;2;22;213790888;215641893;1851005
Jacobs;H148;2;22;215844761;218418759;2573998
Jacobs;H148;2;15;220083076;220955491;872415
Jacobs;H148;24;40;29155367;31943864;2788497
Jacobs;H148;24;24;39603557;41034970;1431413
Jacobs;H149;2;109;158066;6092514;5934448
Jacobs;H149;2;30;13307050;14827510;1520460
Jacobs;H149;2;15;16487040;17140743;653703
Jacobs;H149;2;48;26664802;30026978;3362176
Jacobs;H149;2;82;40790032;45739882;4949850
Jacobs;H149;2;88;58791324;63479215;4687891
Jacobs;H149;2;17;65962375;67012655;1050280
Jacobs;H149;2;35;67625735;69441272;1815537
Jacobs;H149;2;39;80376822;82013700;1636878
Jacobs;H149;2;28;131397735;132608113;1210378
Jacobs;H149;2;34;141007423;142709866;1702443
Jacobs;H150;2;86;29409606;34303557;4893951
Jacobs;H150;2;82;40790032;45739882;4949850
Jacobs;H150;2;25;58791324;60044110;1252786
Jacobs;H150;2;17;65962375;67012655;1050280
Jacobs;H150;2;35;67625735;69441272;1815537
Jacobs;H150;2;39;80376822;82013700;1636878
Jacobs;H150;2;16;94981400;95965733;984333
Jacobs;H150;2;16;115340878;116108127;767249
Jacobs;H150;2;15;116784013;117464089;680076
Jacobs;H150;2;17;122060498;123432784;1372286
Jacobs;H150;2;84;128843993;132967710;4123717
Jacobs;H150;2;34;141007423;142709866;1702443
Jacobs;H150;2;15;232591652;233589543;997891
Jacobs;H150;2;30;241748973;243449101;1700128
Jacobs;H150;24;16;34607110;36160755;1553645
Jacobs;H151;2;59;11555842;14827510;3271668
Jacobs;H151;2;251;16622194;30785949;14163755
Jacobs;H151;2;45;40350901;43558237;3207336
Jacobs;H151;2;28;46833373;48824104;1990731
Jacobs;H151;2;32;51824098;53366034;1541936
Jacobs;H151;2;21;114411448;115743360;1331912
Jacobs;H151;2;15;116108127;117115355;1007228
Jacobs;H151;2;47;132841528;135391568;2550040
Jacobs;H151;2;24;136745970;138081646;1335676
Jacobs;H151;2;50;140158515;142709866;2551351
Jacobs;H151;2;39;147759341;149609364;1850023
Jacobs;H151;2;222;179799000;192989350;13190350
Jacobs;H151;2;47;196829899;199225518;2395619
Jacobs;H151;2;18;210948623;211695755;747132
Jacobs;H151;24;25;8460459;9942134;1481675
Jacobs;H151;24;43;23209530;26142394;2932864
Jacobs;H152;2;16;45686718;46598180;911462
Jacobs;H152;2;45;54240741;56556228;2315487
Jacobs;H152;2;70;80811295;84891847;4080552
Jacobs;H152;2;18;86266274;87138916;872642
Jacobs;H152;2;76;117702396;122001925;4299529
Jacobs;H152;2;87;122096448;126734704;4638256
Jacobs;H152;2;34;133402369;135337045;1934676
Jacobs;H152;2;36;162689295;164516447;1827152
Jacobs;H152;2;15;220083076;220955491;872415
Jacobs;H152;2;47;240684120;243365308;2681188
Jacobs;H152;24;45;17642594;21460746;3818152
Jacobs;H152;24;34;29155367;31359697;2204330
Jacobs;H153;2;103;16622194;21883834;5261640
Jacobs;H153;2;27;22809937;24092677;1282740
Jacobs;H153;2;18;24839164;25709378;870214
Jacobs;H153;2;18;39411236;40350901;939665
Jacobs;H153;2;28;46833373;48824104;1990731
Jacobs;H153;2;147;77200457;85150906;7950449
Jacobs;H153;2;28;98008059;99808715;1800656
Jacobs;H153;2;20;107171359;107911874;740515
Jacobs;H153;2;16;108309773;108954373;644600
Jacobs;H153;2;19;121796989;123432784;1635795
Jacobs;H153;2;118;131649580;137781188;6131608
Jacobs;H153;2;33;142863809;144672338;1808529
Jacobs;H153;2;60;152529090;156095039;3565949
Jacobs;H153;2;56;184565642;188204145;3638503
Jacobs;H153;2;18;210948623;211695755;747132
Jacobs;H153;24;42;96467;3507572;3411105
Jacobs;H153;24;48;16351007;20406106;4055099
Jacobs;H154;2;50;2451471;4697573;2246102
Jacobs;H154;2;23;14359717;15322091;962374
Jacobs;H154;2;15;16487040;17140743;653703
Jacobs;H154;2;48;26664802;30026978;3362176
Jacobs;H154;2;66;30638836;34303557;3664721
Jacobs;H154;2;82;40790032;45739882;4949850
Jacobs;H154;2;16;53991275;54669270;677995
Jacobs;H154;2;105;70548455;76783372;6234917
Jacobs;H154;2;19;121796989;123432784;1635795
Jacobs;H154;2;49;127699622;130206119;2506497
Jacobs;H154;2;20;131793590;132608113;814523
Jacobs;H154;2;22;132802249;133748186;945937
Jacobs;H154;2;37;141766599;143918492;2151893
Jacobs;H154;2;139;155064316;163070840;8006524
Jacobs;H154;2;64;186306661;190154694;3848033
Jacobs;H154;2;68;190267950;193596846;3328896
Jacobs;H154;2;48;199432096;202088645;2656549
Jacobs;H154;2;32;215098553;217890987;2792434
Jacobs;H154;2;15;220083076;220955491;872415
Jacobs;H154;24;67;26493858;31359697;4865839
Jacobs;H155;2;50;2451471;4697573;2246102
Jacobs;H155;2;25;25563222;27209958;1646736
Jacobs;H155;2;16;53991275;54669270;677995
Jacobs;H155;2;97;58791324;63837976;5046652
Jacobs;H155;2;219;65962375;78426196;12463821
Jacobs;H155;2;19;121796989;123432784;1635795
Jacobs;H155;2;49;127699622;130206119;2506497
Jacobs;H155;2;37;162572509;164516447;1943938
Jacobs;H155;2;34;179521559;181909538;2387979
Jacobs;H155;2;45;208020229;210418618;2398389
Jacobs;H155;2;16;215498705;217457102;1958397
Jacobs;H155;2;15;218592494;219847222;1254728
Jacobs;H155;2;15;232591652;233589543;997891
Jacobs;H155;2;30;241748973;243449101;1700128
Jacobs;H155;24;34;26493858;29155367;2661509
