group;id;chrom;nSNP;from;to;lengthBps
Jacobs;H70;2;28;6973371;8910387;1937016
Jacobs;H70;2;25;15388156;16774412;1386256
Jacobs;H70;2;16;18903649;19654697;751048
Jacobs;H70;2;59;66730561;69922573;3192012
Jacobs;H70;2;19;70664942;71739429;1074487
Jacobs;H70;2;15;73109758;73839087;729329
Jacobs;H70;2;38;82507056;84891847;2384791
Jacobs;H70;2;36;93383608;95129267;1745659
Jacobs;H70;2;59;103331488;107079601;3748113
Jacobs;H70;2;16;117158936;117736662;577726
Jacobs;H70;2;20;122060498;123528595;1468097
Jacobs;H70;2;25;136654969;138081646;1426677
Jacobs;H70;2;34;142709866;144672338;1962472
Jacobs;H70;2;22;156405688;157574569;1168881
Jacobs;H70;2;46;167432552;169929278;2496726
Jacobs;H70;2;20;184760567;186193337;1432770
Jacobs;H70;2;50;186925871;189895425;2969554
Jacobs;H70;2;197;196397256;207025377;10628121
Jacobs;H70;2;251;207747048;223876023;16128975
Jacobs;H70;2;18;245149683;246317098;1167415
Jacobs;H70;10;18;22713402;23642798;929396
Jacobs;H70;10;23;29806294;30849548;1043254
Jacobs;H70;10;201;32773769;45845544;13071775
Jacobs;H70;10;40;48323497;50290499;1967002
Jacobs;H70;10;38;52101841;54375509;2273668
Jacobs;H70;10;16;71584455;72901888;1317433
Jacobs;H70;10;29;81117863;82508957;1391094
Jacobs;H70;24;34;16077497;18669354;2591857
Jacobs;H70;24;15;22486632;23689555;1202923
Jacobs;H70;24;99;29375887;36160755;6784868
Jacobs;H71;2;41;14914968;17033754;2118786
Jacobs;H71;2;17;20016014;20816743;800729
Jacobs;H71;2;38;25939009;28578328;2639319
Jacobs;H71;2;17;37618402;38759231;1140829
Jacobs;H71;2;246;42276176;56521561;14245385
Jacobs;H71;2;85;66730561;71739429;5008868
Jacobs;H71;2;35;72013096;73926990;1913894
Jacobs;H71;2;20;75042274;76161143;1118869
Jacobs;H71;2;36;79183271;80967126;1783855
Jacobs;H71;2;35;88784524;91333600;2549076
Jacobs;H71;2;16;94894157;95731895;837738
Jacobs;H71;2;26;121239876;123048197;1808321
Jacobs;H71;2;17;155231390;156095039;863649
Jacobs;H71;2;51;162689295;165285830;2596535
Jacobs;H71;2;18;168799360;169752566;953206
Jacobs;H71;2;54;183793517;187234853;3441336
Jacobs;H71;2;102;193433380;199546123;6112743
Jacobs;H71;2;50;211512445;215251657;3739212
Jacobs;H71;2;52;215844761;220852308;5007547
Jacobs;H71;2;15;227394567;228213023;818456
Jacobs;H71;2;72;229397259;233589543;4192284
Jacobs;H71;2;18;233988816;235032427;1043611
Jacobs;H71;2;59;237076010;240477448;3401438
Jacobs;H71;2;114;240777646;247498052;6720406
Jacobs;H71;10;54;14573661;17651675;3078014
Jacobs;H71;10;28;22955949;24422906;1466957
Jacobs;H71;10;104;25827394;31251390;5423996
Jacobs;H71;10;18;36448017;37738237;1290220
Jacobs;H71;10;20;38727795;40071898;1344103
Jacobs;H71;10;23;46618259;47743423;1125164
Jacobs;H71;10;17;49446895;50699349;1252454
Jacobs;H71;10;21;52101841;53147209;1045368
Jacobs;H71;10;33;64698622;66490268;1791646
Jacobs;H71;10;21;68818754;69896172;1077418
Jacobs;H71;10;74;78641554;82225985;3584431
Jacobs;H71;24;21;5075204;6265369;1190165
Jacobs;H71;24;31;11076801;13647199;2570398
Jacobs;H71;24;15;16077497;17253902;1176405
Jacobs;H71;24;44;17996334;21629724;3633390
Jacobs;H71;24;47;29475441;32552648;3077207
Jacobs;H71;24;58;37613659;42027686;4414027
Jacobs;H72;2;15;6973371;7925142;951771
Jacobs;H72;2;17;20016014;20816743;800729
Jacobs;H72;2;38;25939009;28578328;2639319
Jacobs;H72;2;33;33980393;35655097;1674704
Jacobs;H72;2;35;51720147;53415584;1695437
Jacobs;H72;2;58;53986551;56804497;2817946
Jacobs;H72;2;253;65974765;80421373;14446608
Jacobs;H72;2;15;106521892;107171359;649467
Jacobs;H72;2;32;121515740;123644129;2128389
Jacobs;H72;2;38;133272817;135451498;2178681
Jacobs;H72;2;29;142656135;144426232;1770097
Jacobs;H72;2;15;147910340;148711192;800852
Jacobs;H72;2;18;205244432;206276753;1032321
Jacobs;H72;2;22;211512445;212806608;1294163
Jacobs;H72;2;25;213505877;215641893;2136016
Jacobs;H72;2;15;224864722;225533687;668965
Jacobs;H72;2;71;230238912;234609188;4370276
Jacobs;H72;2;64;236221140;239971864;3750724
Jacobs;H72;10;46;12231314;14856146;2624832
Jacobs;H72;10;30;36353216;38751668;2398452
Jacobs;H72;10;16;44760859;45845544;1084685
Jacobs;H72;10;25;53303637;54955412;1651775
Jacobs;H72;10;38;61831934;65354102;3522168
Jacobs;H72;10;23;67238073;68597311;1359238
Jacobs;H72;24;22;6468168;7796684;1328516
Jacobs;H72;24;16;19819848;21019195;1199347
Jacobs;H72;24;60;33397677;37753985;4356308
Jacobs;H78;2;15;6973371;7925142;951771
Jacobs;H78;2;42;21789864;23805106;2015242
Jacobs;H78;2;26;26737340;28578328;1840988
Jacobs;H78;2;246;42276176;56521561;14245385
Jacobs;H78;2;85;66730561;71739429;5008868
Jacobs;H78;2;68;72013096;75970858;3957762
Jacobs;H78;2;20;77416440;78221205;804765
Jacobs;H78;2;26;85539011;86907702;1368691
Jacobs;H78;2;23;106109303;107227866;1118563
Jacobs;H78;2;15;114411448;115476148;1064700
Jacobs;H78;2;26;121239876;123048197;1808321
Jacobs;H78;2;52;149539226;152437856;2898630
Jacobs;H78;2;37;155606280;157574569;1968289
Jacobs;H78;2;22;163790869;164780655;989786
Jacobs;H78;2;232;165226892;179033953;13807061
Jacobs;H78;2;37;179386745;182097199;2710454
Jacobs;H78;2;104;187856073;193489164;5633091
Jacobs;H78;2;15;195245620;196397256;1151636
Jacobs;H78;2;17;198875303;199681176;805873
Jacobs;H78;2;15;206346660;207322502;975842
Jacobs;H78;2;50;211512445;215251657;3739212
Jacobs;H78;2;36;215844761;219774612;3929851
Jacobs;H78;2;128;226477839;233589543;7111704
Jacobs;H78;2;15;233988816;234937102;948286
Jacobs;H78;2;66;236221140;240085853;3864713
Jacobs;H78;2;15;241839716;242738945;899229
Jacobs;H78;10;26;2277631;3541347;1263716
Jacobs;H78;10;39;5678893;8904686;3225793
Jacobs;H78;10;17;18737350;19689245;951895
Jacobs;H78;10;145;23213276;30849548;7636272
Jacobs;H78;10;29;36883392;39489315;2605923
Jacobs;H78;10;19;40105937;40971187;865250
Jacobs;H78;10;34;46618259;48243886;1625627
Jacobs;H78;10;49;53303637;56665266;3361629
Jacobs;H78;10;21;56914955;58031444;1116489
Jacobs;H78;10;33;64698622;66490268;1791646
Jacobs;H78;10;21;68818754;69896172;1077418
Jacobs;H78;10;74;78641554;82225985;3584431
Jacobs;H78;24;16;11076801;12335936;1259135
Jacobs;H78;24;20;16041579;17514108;1472529
Jacobs;H78;24;103;31821433;38974331;7152898
Jacobs;H78;24;19;40193947;42027686;1833739
Jacobs;H79;2;22;3470694;4456589;985895
Jacobs;H79;2;142;15388156;22860326;7472170
Jacobs;H79;2;16;24839164;25481746;642582
Jacobs;H79;2;26;72607674;74004954;1397280
Jacobs;H79;2;122;121198565;127753578;6555013
Jacobs;H79;2;22;156405688;157574569;1168881
Jacobs;H79;2;31;179842775;181909538;2066763
Jacobs;H79;2;31;182286302;183830160;1543858
Jacobs;H79;2;37;209015882;211068237;2052355
Jacobs;H79;2;84;231424947;235917576;4492629
Jacobs;H79;2;25;238831242;240012290;1181048
Jacobs;H79;10;33;15018558;16929716;1911158
Jacobs;H79;10;46;18737350;21431009;2693659
Jacobs;H79;10;15;26736937;27365899;628962
Jacobs;H79;10;33;29304176;30849548;1545372
Jacobs;H79;10;43;30934700;33533969;2599269
Jacobs;H79;10;18;36448017;37738237;1290220
Jacobs;H79;10;20;38727795;40071898;1344103
Jacobs;H79;10;146;47204631;54955412;7750781
Jacobs;H79;10;24;56240111;57534184;1294073
Jacobs;H79;10;83;65537146;70162514;4625368
Jacobs;H79;10;40;75314642;77234571;1919929
Jacobs;H79;24;17;9268996;10977878;1708882
Jacobs;H79;24;15;31093416;32103135;1009719
Jacobs;H79;24;18;33798780;35216176;1417396
Jacobs;H80;2;15;4080987;4670884;589897
Jacobs;H80;2;17;20016014;20816743;800729
Jacobs;H80;2;137;22396321;30708966;8312645
Jacobs;H80;2;48;54249685;56804497;2554812
Jacobs;H80;2;30;61921092;63447389;1526297
Jacobs;H80;2;36;79183271;80967126;1783855
Jacobs;H80;2;104;83115753;88789712;5673959
Jacobs;H80;2;25;88900607;91063757;2163150
Jacobs;H80;2;18;91996530;93217367;1220837
Jacobs;H80;2;29;108264568;109829764;1565196
Jacobs;H80;2;18;129537914;130636386;1098472
Jacobs;H80;2;23;135836770;137106359;1269589
Jacobs;H80;2;62;140937497;144457580;3520083
Jacobs;H80;2;17;155231390;156095039;863649
Jacobs;H80;2;103;158290735;164241805;5951070
Jacobs;H80;2;17;172616581;173532404;915823
Jacobs;H80;2;40;176369323;178922457;2553134
Jacobs;H80;2;89;179348624;184885519;5536895
Jacobs;H80;2;15;190742274;191402600;660326
Jacobs;H80;2;50;211512445;215251657;3739212
Jacobs;H80;2;52;215844761;220852308;5007547
Jacobs;H80;2;15;227394567;228213023;818456
Jacobs;H80;2;232;229397259;242738945;13341686
Jacobs;H80;10;17;14007878;14856146;848268
Jacobs;H80;10;51;19390547;22376804;2986257
Jacobs;H80;10;362;25827394;47487991;21660597
Jacobs;H80;10;20;47662790;48499817;837027
Jacobs;H80;24;69;16041579;21629724;5588145
Jacobs;H86;2;32;5798140;7433654;1635514
Jacobs;H86;2;142;15388156;22860326;7472170
Jacobs;H86;2;18;101030254;101709271;679017
Jacobs;H86;2;63;117835621;121455578;3619957
Jacobs;H86;2;30;121607287;123644129;2036842
Jacobs;H86;2;40;125273857;127088467;1814610
Jacobs;H86;2;56;130368989;133040292;2671303
Jacobs;H86;2;151;162492078;171000571;8508493
Jacobs;H86;2;55;204702992;207802311;3099319
Jacobs;H86;2;20;218058406;219694019;1635613
Jacobs;H86;2;16;222636869;223262207;625338
Jacobs;H86;2;21;226569909;227734587;1164678
Jacobs;H86;2;18;231424947;232414241;989294
Jacobs;H86;2;18;233988816;235032427;1043611
Jacobs;H86;2;53;237076010;240012290;2936280
Jacobs;H86;10;20;7042162;8904686;1862524
Jacobs;H86;10;15;14523808;15472049;948241
Jacobs;H86;10;180;21682188;31189670;9507482
Jacobs;H86;10;18;36448017;37738237;1290220
Jacobs;H86;10;20;38727795;40071898;1344103
Jacobs;H86;10;49;49876303;52419746;2543443
Jacobs;H86;10;19;72332318;73342462;1010144
Jacobs;H86;10;44;73603634;75620051;2016417
Jacobs;H86;24;17;25884487;27526097;1641610
Jacobs;H86;24;29;32623905;34176391;1552486
Jacobs;H87;2;95;17909542;22860326;4950784
Jacobs;H87;2;16;24839164;25481746;642582
Jacobs;H87;2;17;108072803;108787194;714391
Jacobs;H87;2;16;119450094;120383406;933312
Jacobs;H87;2;18;122301320;123573014;1271694
Jacobs;H87;2;26;138813572;139939771;1126199
Jacobs;H87;2;32;162572509;164308657;1736148
Jacobs;H87;2;122;186224877;193045812;6820935
Jacobs;H87;2;15;203751286;204502491;751205
Jacobs;H87;2;63;207575434;210975950;3400516
Jacobs;H87;2;47;212232636;215498705;3266069
Jacobs;H87;2;19;217653015;219015064;1362049
Jacobs;H87;2;26;219847222;221354646;1507424
Jacobs;H87;2;15;236541718;237613535;1071817
Jacobs;H87;10;111;24977576;30849548;5871972
Jacobs;H87;10;43;30934700;33533969;2599269
Jacobs;H87;10;18;36448017;37738237;1290220
Jacobs;H87;10;20;38727795;40071898;1344103
Jacobs;H87;10;146;47204631;54955412;7750781
Jacobs;H87;10;24;56240111;57534184;1294073
Jacobs;H87;10;17;77795799;78599973;804174
Jacobs;H87;24;30;31556086;33343694;1787608
Jacobs;H87;24;19;40193947;42027686;1833739
Jacobs;H88;2;26;4781740;6149666;1367926
Jacobs;H88;2;16;18903649;19654697;751048
Jacobs;H88;2;19;21690410;22493681;803271
Jacobs;H88;2;44;24966147;27546603;2580456
Jacobs;H88;2;52;54135888;56804497;2668609
Jacobs;H88;2;147;63770877;72147185;8376308
Jacobs;H88;2;15;73109758;73839087;729329
Jacobs;H88;2;27;87222916;88553200;1330284
Jacobs;H88;2;16;105291364;106302944;1011580
Jacobs;H88;2;16;106975218;107627876;652658
Jacobs;H88;2;27;113014357;115476148;2461791
Jacobs;H88;2;32;121515740;123644129;2128389
Jacobs;H88;2;37;133272817;135446006;2173189
Jacobs;H88;2;23;135836770;137106359;1269589
Jacobs;H88;2;153;155606280;164308657;8702377
Jacobs;H88;2;31;182286302;183830160;1543858
Jacobs;H88;2;104;187856073;193489164;5633091
Jacobs;H88;2;15;195245620;196397256;1151636
Jacobs;H88;2;17;198875303;199681176;805873
Jacobs;H88;2;15;206346660;207322502;975842
Jacobs;H88;2;60;211512445;215641893;4129448
Jacobs;H88;2;24;231069887;232414241;1344354
Jacobs;H88;2;15;233988816;234937102;948286
Jacobs;H88;10;39;18527240;20805065;2277825
Jacobs;H88;10;201;32773769;45845544;13071775
Jacobs;H88;10;159;48972916;58031444;9058528
Jacobs;H88;10;15;59776861;60578383;801522
Jacobs;H88;10;27;62729605;65354102;2624497
Jacobs;H88;10;42;75599218;77795799;2196581
Jacobs;H88;10;19;84678999;85596458;917459
Jacobs;H88;24;315;9268996;33343694;24074698
Jacobs;H88;24;34;39214598;42027686;2813088
Jacobs;H93;2;85;158066;4781740;4623674
Jacobs;H93;2;113;10887825;17033754;6145929
Jacobs;H93;2;17;20016014;20816743;800729
Jacobs;H93;2;36;22396321;24157644;1761323
Jacobs;H93;2;20;24756265;25765503;1009238
Jacobs;H93;2;20;31641648;32674404;1032756
Jacobs;H93;2;52;54135888;56804497;2668609
Jacobs;H93;2;28;65402955;67012655;1609700
Jacobs;H93;2;22;72875158;74090507;1215349
Jacobs;H93;2;45;79017511;81273844;2256333
Jacobs;H93;2;20;91996530;93271249;1274719
Jacobs;H93;2;71;103618164;107690483;4072319
Jacobs;H93;2;20;122001925;123494681;1492756
Jacobs;H93;2;15;129831656;130673052;841396
Jacobs;H93;2;60;130880304;133655932;2775628
Jacobs;H93;2;63;139427894;142593638;3165744
Jacobs;H93;2;15;145444039;146243868;799829
Jacobs;H93;2;37;148986290;150755823;1769533
Jacobs;H93;2;97;150948753;156881594;5932841
Jacobs;H93;2;49;168438851;171362036;2923185
Jacobs;H93;2;15;173034908;173684339;649431
Jacobs;H93;2;17;177951142;178764936;813794
Jacobs;H93;2;55;181645416;184760567;3115151
Jacobs;H93;2;62;185805112;189593772;3788660
Jacobs;H93;2;123;193433380;200967287;7533907
Jacobs;H93;2;117;206338485;212806608;6468123
Jacobs;H93;2;148;213505877;224077986;10572109
Jacobs;H93;2;119;231029291;237613535;6584244
Jacobs;H93;10;15;10561517;11356894;795377
Jacobs;H93;10;57;17336717;20686326;3349609
Jacobs;H93;10;119;23604001;29882404;6278403
Jacobs;H93;10;201;32773769;45845544;13071775
Jacobs;H93;10;38;47228374;48993276;1764902
Jacobs;H93;10;23;67238073;68597311;1359238
Jacobs;H93;24;51;4000350;7213312;3212962
Jacobs;H93;24;74;11451480;16811910;5360430
Jacobs;H94;2;39;4080987;5940814;1859827
Jacobs;H94;2;28;22809937;24157644;1347707
Jacobs;H94;2;20;24756265;25765503;1009238
Jacobs;H94;2;20;31641648;32674404;1032756
Jacobs;H94;2;16;39586061;40468426;882365
Jacobs;H94;2;16;57756898;58421191;664293
Jacobs;H94;2;64;63387842;66608553;3220711
Jacobs;H94;2;68;71178447;75042274;3863827
Jacobs;H94;2;66;88784524;93271249;4486725
Jacobs;H94;2;49;99302002;101684673;2382671
Jacobs;H94;2;16;106521892;107227866;705974
Jacobs;H94;2;24;116534114;117736662;1202548
Jacobs;H94;2;23;130368989;131682707;1313718
Jacobs;H94;2;18;134244380;135304995;1060615
Jacobs;H94;2;78;135996954;140442104;4445150
Jacobs;H94;2;15;148323473;149177234;853761
Jacobs;H94;2;15;155789140;156555652;766512
Jacobs;H94;2;21;169752566;171123855;1371289
Jacobs;H94;2;17;183679720;184565642;885922
Jacobs;H94;2;18;205244432;206276753;1032321
Jacobs;H94;2;330;207231826;227734587;20502761
Jacobs;H94;10;15;6551668;8114054;1562386
Jacobs;H94;10;19;12770970;13819705;1048735
Jacobs;H94;10;32;14949320;16721856;1772536
Jacobs;H94;10;149;20508567;28538940;8030373
Jacobs;H94;10;40;47662790;49344061;1681271
Jacobs;H94;10;36;68271380;70162514;1891134
Jacobs;H94;10;159;71470411;80204165;8733754
Jacobs;H94;24;15;9268996;10709974;1440978
Jacobs;H94;24;17;16041579;17307132;1265553
Jacobs;H94;24;17;18834056;20406106;1572050
Jacobs;H94;24;61;24493823;28877449;4383626
Jacobs;H95;2;52;14402382;17033754;2631372
Jacobs;H95;2;17;20016014;20816743;800729
Jacobs;H95;2;141;22396321;30849683;8453362
Jacobs;H95;2;35;51720147;53415584;1695437
Jacobs;H95;2;58;53986551;56804497;2817946
Jacobs;H95;2;119;63387842;69660591;6272749
Jacobs;H95;2;82;70664942;75574972;4910030
Jacobs;H95;2;81;84640849;88789712;4148863
Jacobs;H95;2;33;100603953;102087094;1483141
Jacobs;H95;2;15;109869230;110827578;958348
Jacobs;H95;2;27;122001925;123740047;1738122
Jacobs;H95;2;38;130424187;132323750;1899563
Jacobs;H95;2;21;141512548;142593638;1081090
Jacobs;H95;2;81;156555652;161570453;5014801
Jacobs;H95;2;15;173442788;174361658;918870
Jacobs;H95;2;71;201514161;204902549;3388388
Jacobs;H95;2;82;208232368;212806608;4574240
Jacobs;H95;2;101;231069887;236449805;5379918
Jacobs;H95;10;15;2905602;3761734;856132
Jacobs;H95;10;41;7492074;10273523;2781449
Jacobs;H95;10;20;21309973;22376804;1066831
Jacobs;H95;10;92;27989538;32637918;4648380
Jacobs;H95;10;18;36448017;37738237;1290220
Jacobs;H95;10;20;38727795;40071898;1344103
Jacobs;H95;10;214;41246529;53584052;12337523
Jacobs;H95;10;19;67238073;68339290;1101217
Jacobs;H95;10;17;76428043;77210348;782305
Jacobs;H95;24;24;7615311;8842899;1227588
Jacobs;H95;24;21;15762894;17307132;1544238
Jacobs;H95;24;33;18834056;21629724;2795668
Jacobs;H95;24;67;33313461;38125663;4812202
Jacobs;H95;24;16;39300789;40336394;1035605
Jacobs;H96;2;16;10266961;10887825;620864
Jacobs;H96;2;175;17140743;26480124;9339381
Jacobs;H96;2;19;58791324;59762935;971611
Jacobs;H96;2;22;72875158;74090507;1215349
Jacobs;H96;2;128;88818925;96824814;8005889
Jacobs;H96;2;30;121607287;123644129;2036842
Jacobs;H96;2;22;124467465;125343919;876454
Jacobs;H96;2;22;134667278;135636519;969241
Jacobs;H96;2;51;139427894;141971484;2543590
Jacobs;H96;2;208;145994402;158192547;12198145
Jacobs;H96;2;31;162689295;164308657;1619362
Jacobs;H96;2;529;168220661;200125811;31905150
Jacobs;H96;2;18;215443702;217457102;2013400
Jacobs;H96;2;23;219357404;220955491;1598087
Jacobs;H96;2;66;231069887;235032427;3962540
Jacobs;H96;10;217;21126901;32637918;11511017
Jacobs;H96;10;29;36883392;39489315;2605923
Jacobs;H96;10;19;40105937;40971187;865250
Jacobs;H96;10;34;46618259;48243886;1625627
Jacobs;H96;10;25;52768972;54459673;1690701
Jacobs;H96;10;84;74111393;78378416;4267023
Jacobs;H96;10;39;82590071;84537988;1947917
Jacobs;H96;24;24;39623269;41143981;1520712
Jacobs;H101;2;82;158066;4697573;4539507
Jacobs;H101;2;119;7292599;13932966;6640367
Jacobs;H101;2;15;17733005;18625870;892865
Jacobs;H101;2;18;37164388;38602691;1438303
Jacobs;H101;2;427;46833373;69890535;23057162
Jacobs;H101;2;34;93102704;94768669;1665965
Jacobs;H101;2;342;117573048;136166662;18593614
Jacobs;H101;2;30;142656135;144457580;1801445
Jacobs;H101;2;32;149539226;151345671;1806445
Jacobs;H101;2;83;152160860;157031272;4870412
Jacobs;H101;2;37;173306250;175418941;2112691
Jacobs;H101;2;55;181645416;184760567;3115151
Jacobs;H101;2;44;217719922;220955491;3235569
Jacobs;H101;2;16;221574841;222438632;863791
Jacobs;H101;10;114;4324626;11685764;7361138
Jacobs;H101;10;148;21927581;29882404;7954823
Jacobs;H101;10;15;33986642;34603291;616649
Jacobs;H101;10;35;36637311;39489315;2852004
Jacobs;H101;24;301;17040364;39603557;22563193
Jacobs;H102;2;26;24966147;26480124;1513977
Jacobs;H102;2;151;45658202;54596587;8938385
Jacobs;H102;2;19;70664942;71739429;1074487
Jacobs;H102;2;15;73109758;73839087;729329
Jacobs;H102;2;15;75574972;76411172;836200
Jacobs;H102;2;319;101171470;121455578;20284108
Jacobs;H102;2;30;121607287;123644129;2036842
Jacobs;H102;2;15;129831656;130673052;841396
Jacobs;H102;2;38;133272817;135451498;2178681
Jacobs;H102;2;105;158290735;164308657;6017922
Jacobs;H102;2;18;215443702;217457102;2013400
Jacobs;H102;2;19;221216169;222027261;811092
Jacobs;H102;2;20;239958619;241057841;1099222
Jacobs;H102;10;93;5112716;11501991;6389275
Jacobs;H102;10;45;12245035;14856146;2611111
Jacobs;H102;10;249;30129111;45845544;15716433
Jacobs;H102;10;25;52768972;54459673;1690701
Jacobs;H102;10;20;67493967;68757883;1263916
Jacobs;H102;10;34;74111393;75746175;1634782
Jacobs;H102;10;23;77507372;78682047;1174675
Jacobs;H102;10;22;84620983;85674444;1053461
Jacobs;H102;24;20;2043961;3507572;1463611
Jacobs;H102;24;38;6265369;8379806;2114437
Jacobs;H102;24;28;8741291;11007102;2265811
Jacobs;H102;24;41;33056732;35878194;2821462
Jacobs;H102;24;25;39603557;41143981;1540424
Jacobs;H103;2;28;11834382;13473852;1639470
Jacobs;H103;2;15;17733005;18625870;892865
Jacobs;H103;2;33;30876192;32798936;1922744
Jacobs;H103;2;18;37164388;38602691;1438303
Jacobs;H103;2;322;46045582;63514459;17468877
Jacobs;H103;2;58;66730561;69890535;3159974
Jacobs;H103;2;15;73109758;73839087;729329
Jacobs;H103;2;80;81746910;86669812;4922902
Jacobs;H103;2;22;91063757;92132718;1068961
Jacobs;H103;2;34;93102704;94768669;1665965
Jacobs;H103;2;25;99339620;100812455;1472835
Jacobs;H103;2;111;121198565;127070041;5871476
Jacobs;H103;2;27;127495017;129045322;1550305
Jacobs;H103;2;54;131474019;133942420;2468401
Jacobs;H103;2;17;152048567;153128082;1079515
Jacobs;H103;2;63;181217794;184760567;3542773
Jacobs;H103;2;65;203303306;206886750;3583444
Jacobs;H103;2;18;207575434;208478108;902674
Jacobs;H103;2;47;212232636;215498705;3266069
Jacobs;H103;2;25;217736927;219774612;2037685
Jacobs;H103;2;20;220083076;221153389;1070313
Jacobs;H103;2;22;226617529;227781732;1164203
Jacobs;H103;2;134;230129750;237613535;7483785
Jacobs;H103;10;57;4518697;8904686;4385989
Jacobs;H103;10;15;10155086;10839165;684079
Jacobs;H103;10;46;29806294;31819224;2012930
Jacobs;H103;10;15;33986642;34603291;616649
Jacobs;H103;10;35;36637311;39489315;2852004
Jacobs;H103;10;55;51804306;54955412;3151106
Jacobs;H103;10;40;57089480;59813838;2724358
Jacobs;H103;10;19;65931464;66747944;816480
Jacobs;H103;10;25;68900227;70162514;1262287
Jacobs;H103;10;18;71470411;72901888;1431477
Jacobs;H103;10;66;74681400;78140084;3458684
Jacobs;H103;10;54;78641554;81397746;2756192
Jacobs;H103;10;27;82933307;84137492;1204185
Jacobs;H103;24;48;9352754;13702846;4350092
Jacobs;H103;24;15;22486632;23689555;1202923
Jacobs;H103;24;29;39603557;42027686;2424129
Jacobs;H104;2;26;24966147;26480124;1513977
Jacobs;H104;2;201;45181206;56804497;11623291
Jacobs;H104;2;21;65402955;66608553;1205598
Jacobs;H104;2;19;73828642;74891548;1062906
Jacobs;H104;2;179;79017511;88789712;9772201
Jacobs;H104;2;15;122301320;123494681;1193361
Jacobs;H104;2;38;133272817;135451498;2178681
Jacobs;H104;2;86;139427894;144021471;4593577
Jacobs;H104;2;18;148581376;149451928;870552
Jacobs;H104;2;16;162321953;163109337;787384
Jacobs;H104;2;16;190574847;191319781;744934
Jacobs;H104;2;33;199777656;201797379;2019723
Jacobs;H104;2;18;205244432;206276753;1032321
Jacobs;H104;2;142;208935076;219015064;10079988
Jacobs;H104;2;19;221216169;222027261;811092
Jacobs;H104;2;66;231069887;235032427;3962540
Jacobs;H104;2;37;236470812;238899861;2429049
Jacobs;H104;2;15;243490742;244622796;1132054
Jacobs;H104;10;15;3499526;4405111;905585
Jacobs;H104;10;219;24977576;36653024;11675448
Jacobs;H104;10;29;36883392;39489315;2605923
Jacobs;H104;10;19;40105937;40971187;865250
Jacobs;H104;10;30;47662790;48972916;1310126
Jacobs;H104;10;194;49344061;60964115;11620054
Jacobs;H104;10;37;81307769;83178936;1871167
Jacobs;H104;24;20;2043961;3507572;1463611
Jacobs;H104;24;88;16114681;23497703;7383022
Jacobs;H108;2;31;7925142;9735180;1810038
Jacobs;H108;2;15;17733005;18625870;892865
Jacobs;H108;2;873;25243715;76411172;51167457
Jacobs;H108;2;155;76627899;84802665;8174766
Jacobs;H108;2;28;84938566;86582074;1643508
Jacobs;H108;2;47;107035638;109132360;2096722
Jacobs;H108;2;23;122001925;123573014;1571089
Jacobs;H108;2;17;125977687;126734704;757017
Jacobs;H108;2;21;132635669;133563038;927369
Jacobs;H108;2;130;147821995;155231390;7409395
Jacobs;H108;2;24;196397256;197705689;1308433
Jacobs;H108;2;25;200017570;201514161;1496591
Jacobs;H108;2;22;211512445;212806608;1294163
Jacobs;H108;2;162;213505877;224825575;11319698
Jacobs;H108;2;17;245149683;246249900;1100217
Jacobs;H108;10;27;12231314;13819705;1588391
Jacobs;H108;10;75;25827394;29882404;4055010
Jacobs;H108;10;364;32773769;54375509;21601740
Jacobs;H108;10;23;67238073;68597311;1359238
Jacobs;H108;10;17;76428043;77210348;782305
Jacobs;H108;10;136;78641554;85596458;6954904
Jacobs;H108;24;74;11451480;16811910;5360430
Jacobs;H108;24;26;32598869;33953578;1354709
Jacobs;H109;2;20;4835268;5940814;1105546
Jacobs;H109;2;16;20046763;20816743;769980
Jacobs;H109;2;141;22396321;30849683;8453362
Jacobs;H109;2;45;35582012;38744795;3162783
Jacobs;H109;2;15;39198369;40023789;825420
Jacobs;H109;2;16;52327990;53043790;715800
Jacobs;H109;2;19;53986551;54687816;701265
Jacobs;H109;2;22;72875158;74090507;1215349
Jacobs;H109;2;74;84640849;88553200;3912351
Jacobs;H109;2;18;91996530;93217367;1220837
Jacobs;H109;2;131;96309972;104101891;7791919
Jacobs;H109;2;118;118134501;125030378;6895877
Jacobs;H109;2;42;125273857;127173649;1899792
Jacobs;H109;2;23;130368989;131682707;1313718
Jacobs;H109;2;51;139427894;141971484;2543590
Jacobs;H109;2;17;167533866;168355070;821204
Jacobs;H109;2;33;199777656;201797379;2019723
Jacobs;H109;2;18;205244432;206276753;1032321
Jacobs;H109;2;149;208935076;219694019;10758943
Jacobs;H109;2;18;221245334;222027261;781927
Jacobs;H109;2;90;231069887;235917576;4847689
Jacobs;H109;10;15;6551668;8114054;1562386
Jacobs;H109;10;25;28183710;29415140;1231430
Jacobs;H109;10;21;30004053;30931408;927355
Jacobs;H109;10;34;46618259;48243886;1625627
Jacobs;H109;10;54;57926741;61273031;3346290
Jacobs;H109;10;18;67493967;68694545;1200578
Jacobs;H109;10;20;82069900;83178936;1109036
Jacobs;H109;10;32;83964085;85674444;1710359
Jacobs;H109;24;87;11076801;17307132;6230331
Jacobs;H109;24;20;19946691;21581821;1635130
Jacobs;H110;2;25;2278905;3337073;1058168
Jacobs;H110;2;131;7433654;14837808;7404154
Jacobs;H110;2;17;20016014;20816743;800729
Jacobs;H110;2;830;22396321;70126155;47729834
Jacobs;H110;2;38;72875158;75042274;2167116
Jacobs;H110;2;181;75644823;85508894;9864071
Jacobs;H110;2;21;89567061;91063757;1496696
Jacobs;H110;2;319;96309972;117158936;20848964
Jacobs;H110;2;150;119654696;127495017;7840321
Jacobs;H110;2;21;131474019;132323750;849731
Jacobs;H110;2;88;137672630;142593638;4921008
Jacobs;H110;2;334;145444039;164903825;19459786
Jacobs;H110;2;49;168438851;171362036;2923185
Jacobs;H110;2;15;173034908;173684339;649431
Jacobs;H110;2;17;177951142;178764936;813794
Jacobs;H110;2;56;181645416;184813524;3168108
Jacobs;H110;2;27;187856073;189593772;1737699
Jacobs;H110;2;32;194853812;197093416;2239604
Jacobs;H110;2;24;199432096;200967287;1535191
Jacobs;H110;2;15;207971469;208671645;700176
Jacobs;H110;2;22;211512445;212806608;1294163
Jacobs;H110;2;162;213505877;224825575;11319698
Jacobs;H110;2;44;236470812;239149511;2678699
Jacobs;H110;2;27;239564082;241057841;1493759
Jacobs;H110;2;16;241748973;242738945;989972
Jacobs;H110;10;49;12770970;15587696;2816726
Jacobs;H110;10;329;25827394;45845544;20018150
Jacobs;H110;10;38;47228374;48993276;1764902
Jacobs;H110;10;23;67238073;68597311;1359238
Jacobs;H110;24;405;11451480;42027686;30576206
Jacobs;H111;2;71;1606489;5011935;3405446
Jacobs;H111;2;124;10448019;17033754;6585735
Jacobs;H111;2;17;20016014;20816743;800729
Jacobs;H111;2;200;22396321;34303557;11907236
Jacobs;H111;2;16;52327990;53043790;715800
Jacobs;H111;2;36;53304271;54936988;1632717
Jacobs;H111;2;17;73046724;73926990;880266
Jacobs;H111;2;36;79183271;80967126;1783855
Jacobs;H111;2;221;83531972;96618831;13086859
Jacobs;H111;2;18;101030254;101709271;679017
Jacobs;H111;2;20;113897647;115476148;1578501
Jacobs;H111;2;21;121796989;123494681;1697692
Jacobs;H111;2;54;126125592;128972285;2846693
Jacobs;H111;2;44;141512548;144021471;2508923
Jacobs;H111;2;16;162321953;163109337;787384
Jacobs;H111;2;99;199777656;204902549;5124893
Jacobs;H111;2;20;206427786;207694488;1266702
Jacobs;H111;2;71;208935076;212806608;3871532
Jacobs;H111;2;23;219357404;220955491;1598087
Jacobs;H111;2;18;221245334;222027261;781927
Jacobs;H111;2;90;231069887;235917576;4847689
Jacobs;H111;10;41;21682188;23902878;2220690
Jacobs;H111;10;16;25034802;25827394;792592
Jacobs;H111;10;15;26736937;27365899;628962
Jacobs;H111;10;283;30072709;47487991;17415282
Jacobs;H111;10;22;74631551;75746175;1114624
Jacobs;H111;10;19;82083004;83178936;1095932
Jacobs;H111;24;21;15762894;17307132;1544238
Jacobs;H111;24;32;24740555;27416389;2675834
Jacobs;H111;24;15;28677855;29652597;974742
Jacobs;H111;24;34;32354842;34176391;1821549
Jacobs;H111;24;25;39603557;41143981;1540424
Jacobs;H112;2;103;4080987;9735180;5654193
Jacobs;H112;2;17;20016014;20816743;800729
Jacobs;H112;2;141;22396321;30849683;8453362
Jacobs;H112;2;35;51720147;53415584;1695437
Jacobs;H112;2;305;53986551;69660591;15674040
Jacobs;H112;2;20;70664942;71793127;1128185
Jacobs;H112;2;28;73475221;75042274;1567053
Jacobs;H112;2;102;84054194;90362958;6308764
Jacobs;H112;2;31;90752876;92213984;1461108
Jacobs;H112;2;22;98270309;99578900;1308591
Jacobs;H112;2;20;113897647;115476148;1578501
Jacobs;H112;2;27;122001925;123740047;1738122
Jacobs;H112;2;35;133459225;135446006;1986781
Jacobs;H112;2;26;136654969;138151463;1496494
Jacobs;H112;2;45;141299872;143864562;2564690
Jacobs;H112;2;176;144931308;155231390;10300082
Jacobs;H112;2;15;167511192;168264380;753188
Jacobs;H112;2;59;170058634;173442788;3384154
Jacobs;H112;2;28;175305722;177124764;1819042
Jacobs;H112;2;22;177580706;178764936;1184230
Jacobs;H112;2;20;184760567;186193337;1432770
Jacobs;H112;2;45;189539157;191673164;2134007
Jacobs;H112;2;61;202088645;205069983;2981338
Jacobs;H112;2;16;215443702;216807667;1363965
Jacobs;H112;2;19;228130504;229023952;893448
Jacobs;H112;2;18;245149683;246317098;1167415
Jacobs;H112;10;16;12376514;13428227;1051713
Jacobs;H112;10;15;14485571;15306798;821227
Jacobs;H112;10;47;18402394;21309973;2907579
Jacobs;H112;10;128;25827394;32637918;6810524
Jacobs;H112;10;18;36448017;37738237;1290220
Jacobs;H112;10;20;38727795;40071898;1344103
Jacobs;H112;10;225;41246529;54375509;13128980
Jacobs;H112;10;41;57077569;59813838;2736269
Jacobs;H112;10;41;66017132;68339290;2322158
Jacobs;H112;10;17;76428043;77210348;782305
Jacobs;H112;24;32;24740555;27416389;2675834
Jacobs;H112;24;16;33313461;33953578;640117
Jacobs;H117;2;54;1606489;4252497;2646008
Jacobs;H117;2;16;7347673;8531299;1183626
Jacobs;H117;2;49;14508559;17033754;2525195
Jacobs;H117;2;17;20016014;20816743;800729
Jacobs;H117;2;16;52327990;53043790;715800
Jacobs;H117;2;19;53986551;54687816;701265
Jacobs;H117;2;19;58791324;59762935;971611
Jacobs;H117;2;22;72875158;74090507;1215349
Jacobs;H117;2;71;84791414;88553200;3761786
Jacobs;H117;2;15;91996530;93013077;1016547
Jacobs;H117;2;17;103407822;104281644;873822
Jacobs;H117;2;21;121796989;123494681;1697692
Jacobs;H117;2;173;126344239;135451498;9107259
Jacobs;H117;2;105;158290735;164308657;6017922
Jacobs;H117;2;16;190574847;191319781;744934
Jacobs;H117;2;61;215594803;220955491;5360688
Jacobs;H117;2;69;221633575;225193189;3559614
Jacobs;H117;10;15;2329436;2953668;624232
Jacobs;H117;10;38;18737350;20934075;2196725
Jacobs;H117;10;48;30129111;32637918;2508807
Jacobs;H117;10;29;36883392;39489315;2605923
Jacobs;H117;10;19;40105937;40971187;865250
Jacobs;H117;10;34;46618259;48243886;1625627
Jacobs;H117;10;62;49239297;52419746;3180449
Jacobs;H117;24;102;5978910;12952274;6973364
Jacobs;H117;24;25;39603557;41143981;1540424
Jacobs;H65;2;40;4166902;6003251;1836349
Jacobs;H65;2;27;6973371;8846903;1873532
Jacobs;H65;2;16;18903649;19654697;751048
Jacobs;H65;2;16;35465947;36228409;762462
Jacobs;H65;2;1059;42276176;102214294;59938118
Jacobs;H65;2;27;113014357;115476148;2461791
Jacobs;H65;2;114;121515740;127753578;6237838
Jacobs;H65;2;21;144603941;145745763;1141822
Jacobs;H65;2;16;148986290;149553962;567672
Jacobs;H65;2;34;155064316;156881594;1817278
Jacobs;H65;2;15;170218116;171206036;987920
Jacobs;H65;2;59;186306661;189895425;3588764
Jacobs;H65;2;20;218058406;219694019;1635613
Jacobs;H65;2;20;221216169;222080667;864498
Jacobs;H65;2;25;238831242;240012290;1181048
Jacobs;H65;10;111;24977576;30849548;5871972
Jacobs;H65;10;43;30934700;33533969;2599269
Jacobs;H65;10;18;36448017;37738237;1290220
Jacobs;H65;10;20;38727795;40071898;1344103
Jacobs;H65;10;282;47204631;63941191;16736560
Jacobs;H65;10;42;64913571;67307992;2394421
Jacobs;H65;10;20;67725438;69051759;1326321
Jacobs;H65;10;19;75369154;76300586;931432
Jacobs;H65;24;70;31359697;36160755;4801058
Jacobs;H66;2;40;4166902;6003251;1836349
Jacobs;H66;2;138;7925142;15316224;7391082
Jacobs;H66;2;38;27311358;30051860;2740502
Jacobs;H66;2;16;36871168;38183817;1312649
Jacobs;H66;2;55;52327990;54936988;2608998
Jacobs;H66;2;124;63387842;69922573;6534731
Jacobs;H66;2;76;70664942;75042274;4377332
Jacobs;H66;2;33;80857803;82557618;1699815
Jacobs;H66;2;26;84640849;86164251;1523402
Jacobs;H66;2;31;90752876;92213984;1461108
Jacobs;H66;2;62;92631842;96074249;3442407
Jacobs;H66;2;27;121734938;123644129;1909191
Jacobs;H66;2;40;125273857;127088467;1814610
Jacobs;H66;2;70;127495017;131397735;3902718
Jacobs;H66;2;20;142250151;143383002;1132851
Jacobs;H66;2;27;143864562;145351705;1487143
Jacobs;H66;2;37;148986290;150755823;1769533
Jacobs;H66;2;97;150948753;156881594;5932841
Jacobs;H66;2;20;188693526;189895425;1201899
Jacobs;H66;2;39;199432096;201797379;2365283
Jacobs;H66;2;18;205244432;206276753;1032321
Jacobs;H66;2;15;207971469;208671645;700176
Jacobs;H66;2;22;211512445;212806608;1294163
Jacobs;H66;2;24;213674776;215641893;1967117
Jacobs;H66;10;27;12231314;13819705;1588391
Jacobs;H66;10;122;23289566;29882404;6592838
Jacobs;H66;10;20;53048271;54375509;1327238
Jacobs;H66;10;102;77234571;82508957;5274386
Jacobs;H66;24;60;13299441;17307132;4007691
Jacobs;H67;2;16;21825858;22493681;667823
Jacobs;H67;2;27;25939009;27546603;1607594
Jacobs;H67;2;18;37164388;38602691;1438303
Jacobs;H67;2;172;42786287;53043790;10257503
Jacobs;H67;2;52;54135888;56804497;2668609
Jacobs;H67;2;28;65402955;67012655;1609700
Jacobs;H67;2;21;70664942;71844617;1179675
Jacobs;H67;2;20;73508928;74700075;1191147
Jacobs;H67;2;48;76836434;79017511;2181077
Jacobs;H67;2;42;79183271;81273844;2090573
Jacobs;H67;2;16;94561848;95129267;567419
Jacobs;H67;2;29;96022899;97741243;1718344
Jacobs;H67;2;18;103143424;104101891;958467
Jacobs;H67;2;20;122060498;123528595;1468097
Jacobs;H67;2;36;138618372;140442104;1823732
Jacobs;H67;2;40;140937497;143177828;2240331
Jacobs;H67;2;46;149768329;152437856;2669527
Jacobs;H67;2;106;155026089;161381940;6355851
Jacobs;H67;2;61;162492078;165636711;3144633
Jacobs;H67;2;37;173306250;175418941;2112691
Jacobs;H67;2;53;184760567;188204145;3443578
Jacobs;H67;2;22;211512445;212806608;1294163
Jacobs;H67;2;24;213674776;215641893;1967117
Jacobs;H67;2;20;221216169;222080667;864498
Jacobs;H67;2;15;224864722;225533687;668965
Jacobs;H67;2;16;227127050;228019818;892768
Jacobs;H67;2;18;231424947;232414241;989294
Jacobs;H67;2;15;233988816;234937102;948286
Jacobs;H67;2;64;236221140;239971864;3750724
Jacobs;H67;10;56;13112312;16222665;3110353
Jacobs;H67;10;58;17388048;20805065;3417017
Jacobs;H67;10;37;23262240;25228106;1965866
Jacobs;H67;10;48;30129111;32637918;2508807
Jacobs;H67;10;30;36353216;38751668;2398452
Jacobs;H67;10;16;44760859;45845544;1084685
Jacobs;H67;10;40;57089480;59813838;2724358
Jacobs;H67;24;22;6468168;7796684;1328516
Jacobs;H67;24;18;16310285;17642594;1332309
Jacobs;H67;24;19;40193947;42027686;1833739
Jacobs;H68;2;26;4781740;6149666;1367926
Jacobs;H68;2;28;22809937;24157644;1347707
Jacobs;H68;2;173;75574972;84791414;9216442
Jacobs;H68;2;26;85539011;86907702;1368691
Jacobs;H68;2;16;105291364;106302944;1011580
Jacobs;H68;2;16;106975218;107627876;652658
Jacobs;H68;2;27;113014357;115476148;2461791
Jacobs;H68;2;32;121515740;123644129;2128389
Jacobs;H68;2;24;145994402;147650770;1656368
Jacobs;H68;2;24;169929278;171362036;1432758
Jacobs;H68;2;22;177580706;178764936;1184230
Jacobs;H68;2;17;183793517;184760567;967050
Jacobs;H68;2;54;193151043;196669044;3518001
Jacobs;H68;2;18;205244432;206276753;1032321
Jacobs;H68;2;71;208935076;212806608;3871532
Jacobs;H68;2;61;213505877;219307961;5802084
Jacobs;H68;2;34;223262207;224998163;1735956
Jacobs;H68;2;84;231424947;235917576;4492629
Jacobs;H68;10;15;3499526;4405111;905585
Jacobs;H68;10;37;17061324;19157373;2096049
Jacobs;H68;10;37;23262240;25228106;1965866
Jacobs;H68;10;28;25768345;27398550;1630205
Jacobs;H68;10;227;30129111;44495989;14366878
Jacobs;H68;10;425;45083665;70162514;25078849
Jacobs;H68;10;33;83855530;85596458;1740928
Jacobs;H68;24;17;9268996;10977878;1708882
Jacobs;H68;24;16;19819848;21019195;1199347
Jacobs;H68;24;20;24846522;26068027;1221505
Jacobs;H68;24;34;39214598;42027686;2813088
Jacobs;H69;2;40;4166902;6003251;1836349
Jacobs;H69;2;28;6973371;8910387;1937016
Jacobs;H69;2;29;15388156;16975392;1587236
Jacobs;H69;2;26;21614658;22860326;1245668
Jacobs;H69;2;17;24756265;25481746;725481
Jacobs;H69;2;26;85539011;86907702;1368691
Jacobs;H69;2;15;109007567;110083416;1075849
Jacobs;H69;2;32;121515740;123644129;2128389
Jacobs;H69;2;40;125273857;127088467;1814610
Jacobs;H69;2;16;130368989;131210129;841140
Jacobs;H69;2;15;135636519;136565040;928521
Jacobs;H69;2;75;163790869;167736523;3945654
Jacobs;H69;2;163;168068688;177872397;9803709
Jacobs;H69;2;34;187836750;189895425;2058675
Jacobs;H69;2;42;204702992;207040648;2337656
Jacobs;H69;2;83;208202599;212806608;4604009
Jacobs;H69;2;137;213674776;223564458;9889682
Jacobs;H69;2;38;227644968;229404707;1759739
Jacobs;H69;2;18;231424947;232414241;989294
Jacobs;H69;2;18;233988816;235032427;1043611
Jacobs;H69;2;53;237076010;240012290;2936280
Jacobs;H69;10;55;7492074;11027862;3535788
Jacobs;H69;10;17;18402394;19399049;996655
Jacobs;H69;10;111;24977576;30849548;5871972
Jacobs;H69;10;201;32773769;45845544;13071775
Jacobs;H69;10;49;49876303;52419746;2543443
Jacobs;H69;24;29;39432711;41600515;2167804
Jacobs;H73;2;15;158066;1539578;1381512
Jacobs;H73;2;21;14827510;15802281;974771
Jacobs;H73;2;18;30492514;31353780;861266
Jacobs;H73;2;16;35465947;36228409;762462
Jacobs;H73;2;142;42276176;50949347;8673171
Jacobs;H73;2;123;63414624;69922573;6507949
Jacobs;H73;2;76;70664942;75042274;4377332
Jacobs;H73;2;33;80857803;82557618;1699815
Jacobs;H73;2;26;84640849;86164251;1523402
Jacobs;H73;2;95;90752876;96022899;5270023
Jacobs;H73;2;27;121734938;123644129;1909191
Jacobs;H73;2;40;125273857;127088467;1814610
Jacobs;H73;2;70;127495017;131397735;3902718
Jacobs;H73;2;1103;142250151;207025377;64775226
Jacobs;H73;2;191;207747048;220955491;13208443
Jacobs;H73;2;100;221940916;227127050;5186134
Jacobs;H73;10;27;25827394;27398550;1571156
Jacobs;H73;10;28;29238591;30490110;1251519
Jacobs;H73;10;20;36883392;38751668;1868276
Jacobs;H73;10;17;49446895;50699349;1252454
Jacobs;H73;10;18;53898937;54893114;994177
Jacobs;H73;10;24;56240111;57534184;1294073
Jacobs;H73;10;16;67307992;68271380;963388
Jacobs;H73;10;19;75369154;76300586;931432
Jacobs;H73;24;79;11682465;17307132;5624667
Jacobs;H74;2;49;158066;3206104;3048038
Jacobs;H74;2;20;4080987;4835268;754281
Jacobs;H74;2;38;6149666;8518359;2368693
Jacobs;H74;2;28;22809937;24157644;1347707
Jacobs;H74;2;20;24756265;25765503;1009238
Jacobs;H74;2;70;54744188;58123258;3379070
Jacobs;H74;2;36;79183271;80967126;1783855
Jacobs;H74;2;102;83531972;89359755;5827783
Jacobs;H74;2;18;91996530;93217367;1220837
Jacobs;H74;2;18;101030254;101709271;679017
Jacobs;H74;2;21;121796989;123494681;1697692
Jacobs;H74;2;40;142709866;145090781;2380915
Jacobs;H74;2;15;162765073;163489017;723944
Jacobs;H74;2;89;179348624;184885519;5536895
Jacobs;H74;2;15;190742274;191402600;660326
Jacobs;H74;2;177;197148559;206427786;9279227
Jacobs;H74;2;97;207575434;212806608;5231174
Jacobs;H74;2;15;225231192;226003694;772502
Jacobs;H74;2;17;227127050;228074336;947286
Jacobs;H74;2;54;237076010;240085853;3009843
Jacobs;H74;2;36;243449101;245737846;2288745
Jacobs;H74;10;16;6551668;8404113;1852445
Jacobs;H74;10;68;29238591;32637918;3399327
Jacobs;H74;10;29;36883392;39489315;2605923
Jacobs;H74;10;19;40105937;40971187;865250
Jacobs;H74;10;40;46618259;48499817;1881558
Jacobs;H74;10;68;49239297;52630202;3390905
Jacobs;H74;10;23;52768972;54375509;1606537
Jacobs;H74;24;16;13170165;14101008;930843
Jacobs;H74;24;18;34460565;36160755;1700190
Jacobs;H74;24;18;37965791;39214598;1248807
Jacobs;H75;2;40;4166902;6003251;1836349
Jacobs;H75;2;28;6973371;8910387;1937016
Jacobs;H75;2;15;12697516;13571895;874379
Jacobs;H75;2;26;21614658;22860326;1245668
Jacobs;H75;2;16;24839164;25481746;642582
Jacobs;H75;2;18;67763382;68718997;955615
Jacobs;H75;2;20;76161143;77293547;1132404
Jacobs;H75;2;30;121607287;123644129;2036842
Jacobs;H75;2;40;125273857;127088467;1814610
Jacobs;H75;2;16;130368989;131210129;841140
Jacobs;H75;2;15;135636519;136565040;928521
Jacobs;H75;2;129;163790869;171000571;7209702
Jacobs;H75;2;185;196397256;206276753;9879497
Jacobs;H75;2;36;209050239;211068237;2017998
Jacobs;H75;2;20;218058406;219694019;1635613
Jacobs;H75;2;16;222636869;223262207;625338
Jacobs;H75;10;36;7492074;10010195;2518121
Jacobs;H75;10;111;24977576;30849548;5871972
Jacobs;H75;10;43;30934700;33533969;2599269
Jacobs;H75;10;18;36448017;37738237;1290220
Jacobs;H75;10;20;38727795;40071898;1344103
Jacobs;H75;10;146;47204631;54955412;7750781
Jacobs;H75;10;24;56240111;57534184;1294073
Jacobs;H75;10;38;66897110;69208998;2311888
Jacobs;H75;10;35;77011574;78876406;1864832
Jacobs;H75;10;33;83855530;85596458;1740928
Jacobs;H75;24;24;27620251;29314003;1693752
Jacobs;H76;2;28;9490117;10649928;1159811
Jacobs;H76;2;28;22809937;24157644;1347707
Jacobs;H76;2;18;30492514;31353780;861266
Jacobs;H76;2;19;70664942;71739429;1074487
Jacobs;H76;2;15;73109758;73839087;729329
Jacobs;H76;2;18;91996530;93217367;1220837
Jacobs;H76;2;15;103407822;104249934;842112
Jacobs;H76;2;17;123688719;124570403;881684
Jacobs;H76;2;58;126239415;129196314;2956899
Jacobs;H76;2;71;131649580;135136548;3486968
Jacobs;H76;2;67;140622573;144457580;3835007
Jacobs;H76;2;17;155231390;156095039;863649
Jacobs;H76;2;166;162572509;172085406;9512897
Jacobs;H76;2;37;173306250;175418941;2112691
Jacobs;H76;2;53;184760567;188204145;3443578
Jacobs;H76;2;37;204702992;206643029;1940037
Jacobs;H76;2;50;211512445;215251657;3739212
Jacobs;H76;2;85;215844761;222552458;6707697
Jacobs;H76;2;31;238831242;240477448;1646206
Jacobs;H76;10;18;18527240;19534616;1007376
Jacobs;H76;10;30;21682188;23256944;1574756
Jacobs;H76;10;16;30072709;30849548;776839
Jacobs;H76;10;30;30934700;32637918;1703218
Jacobs;H76;10;34;41802553;44519802;2717249
Jacobs;H76;10;25;48323497;49344061;1020564
Jacobs;H76;10;49;53303637;56665266;3361629
Jacobs;H76;10;43;56914955;59813838;2898883
Jacobs;H76;10;27;62729605;65354102;2624497
Jacobs;H76;10;17;77795799;78599973;804174
Jacobs;H76;24;25;7615311;8874963;1259652
Jacobs;H76;24;27;20838669;23002452;2163783
Jacobs;H76;24;19;40193947;42027686;1833739
Jacobs;H77;2;49;158066;3206104;3048038
Jacobs;H77;2;16;7011767;8023190;1011423
Jacobs;H77;2;16;21825858;22493681;667823
Jacobs;H77;2;27;25939009;27546603;1607594
Jacobs;H77;2;259;35041747;51384849;16343102
Jacobs;H77;2;88;52327990;56804497;4476507
Jacobs;H77;2;85;66730561;71739429;5008868
Jacobs;H77;2;15;73109758;73839087;729329
Jacobs;H77;2;20;75042274;76161143;1118869
Jacobs;H77;2;21;79189919;80421373;1231454
Jacobs;H77;2;27;113014357;115476148;2461791
Jacobs;H77;2;113;121515740;127699622;6183882
Jacobs;H77;2;51;132635669;135391568;2755899
Jacobs;H77;2;66;140622573;144426232;3803659
Jacobs;H77;2;24;155606280;156881594;1275314
Jacobs;H77;2;34;186193337;188204145;2010808
Jacobs;H77;2;16;194563518;195861753;1298235
Jacobs;H77;2;17;198875303;199681176;805873
Jacobs;H77;2;213;206346660;220955491;14608831
Jacobs;H77;2;39;221940916;223876023;1935107
Jacobs;H77;2;22;226617529;227781732;1164203
Jacobs;H77;2;64;236221140;239971864;3750724
Jacobs;H77;10;20;36883392;38751668;1868276
Jacobs;H77;10;19;41560645;43417893;1857248
Jacobs;H77;10;30;53048271;54955412;1907141
Jacobs;H77;10;24;56240111;57534184;1294073
Jacobs;H77;10;34;62212986;65354102;3141116
Jacobs;H77;10;23;67238073;68597311;1359238
Jacobs;H77;24;18;15762894;17159602;1396708
Jacobs;H77;24;16;19819848;21019195;1199347
Jacobs;H77;24;22;21878624;23689555;1810931
Jacobs;H77;24;34;39214598;42027686;2813088
Jacobs;H81;2;69;985851;4456589;3470738
Jacobs;H81;2;39;14827510;16774412;1946902
Jacobs;H81;2;16;18903649;19654697;751048
Jacobs;H81;2;19;21690410;22493681;803271
Jacobs;H81;2;200;35041747;48147405;13105658
Jacobs;H81;2;77;50949347;54936988;3987641
Jacobs;H81;2;18;57559602;58198123;638521
Jacobs;H81;2;59;66730561;69922573;3192012
Jacobs;H81;2;19;70664942;71739429;1074487
Jacobs;H81;2;15;73109758;73839087;729329
Jacobs;H81;2;38;82507056;84891847;2384791
Jacobs;H81;2;85;86104148;91063757;4959609
Jacobs;H81;2;18;91996530;93217367;1220837
Jacobs;H81;2;59;103331488;107079601;3748113
Jacobs;H81;2;16;117158936;117736662;577726
Jacobs;H81;2;22;122001925;123541288;1539363
Jacobs;H81;2;23;140044111;141180010;1135899
Jacobs;H81;2;42;142250151;144615833;2365682
Jacobs;H81;2;90;202389170;207025377;4636207
Jacobs;H81;2;191;207747048;220955491;13208443
Jacobs;H81;2;100;221940916;227127050;5186134
Jacobs;H81;10;31;20551435;22376804;1825369
Jacobs;H81;10;27;25827394;27398550;1571156
Jacobs;H81;10;28;29238591;30490110;1251519
Jacobs;H81;10;20;36883392;38751668;1868276
Jacobs;H81;10;17;49446895;50699349;1252454
Jacobs;H81;10;18;53898937;54893114;994177
Jacobs;H81;10;24;56240111;57534184;1294073
Jacobs;H81;10;16;67307992;68271380;963388
Jacobs;H81;10;19;75369154;76300586;931432
Jacobs;H81;24;20;2748756;4325906;1577150
Jacobs;H81;24;79;16077497;22561935;6484438
Jacobs;H81;24;40;29197813;31947993;2750180
Jacobs;H81;24;93;34345815;42027686;7681871
Jacobs;H82;2;15;6973371;7925142;951771
Jacobs;H82;2;42;21789864;23805106;2015242
Jacobs;H82;2;26;26737340;28578328;1840988
Jacobs;H82;2;18;37164388;38602691;1438303
Jacobs;H82;2;141;42786287;51384849;8598562
Jacobs;H82;2;66;54135888;57495366;3359478
Jacobs;H82;2;21;70664942;71844617;1179675
Jacobs;H82;2;20;73508928;74700075;1191147
Jacobs;H82;2;186;76595968;86582074;9986106
Jacobs;H82;2;58;94478102;97741243;3263141
Jacobs;H82;2;18;103796345;105189556;1393211
Jacobs;H82;2;15;122301320;123494681;1193361
Jacobs;H82;2;85;131793590;136166662;4373072
Jacobs;H82;2;42;142656135;145090781;2434646
Jacobs;H82;2;92;152160860;157574569;5413709
Jacobs;H82;2;234;165093971;179033953;13939982
Jacobs;H82;2;37;179386745;182097199;2710454
Jacobs;H82;2;53;184760567;188204145;3443578
Jacobs;H82;2;50;211512445;215251657;3739212
Jacobs;H82;2;52;215844761;220852308;5007547
Jacobs;H82;2;29;230789586;232414241;1624655
Jacobs;H82;2;19;233988816;235046820;1058004
Jacobs;H82;2;58;236768061;240085853;3317792
Jacobs;H82;2;24;242316517;243490742;1174225
Jacobs;H82;10;26;2277631;3541347;1263716
Jacobs;H82;10;60;4405111;8904686;4499575
Jacobs;H82;10;330;30129111;49721102;19591991
Jacobs;H82;10;33;52388827;54375509;1986682
Jacobs;H82;10;56;57089480;60724939;3635459
Jacobs;H82;10;24;64698622;66062576;1363954
Jacobs;H82;10;35;67609179;69603264;1994085
Jacobs;H82;10;74;71470411;75746175;4275764
Jacobs;H82;24;15;1211676;2578020;1366344
Jacobs;H82;24;59;6819203;10709974;3890771
Jacobs;H82;24;15;12909856;13922554;1012698
Jacobs;H82;24;20;16041579;17514108;1472529
Jacobs;H82;24;103;31821433;38974331;7152898
Jacobs;H82;24;19;40193947;42027686;1833739
Jacobs;H83;2;25;16805125;18001962;1196837
Jacobs;H83;2;16;18903649;19654697;751048
Jacobs;H83;2;16;35465947;36228409;762462
Jacobs;H83;2;142;42276176;50949347;8673171
Jacobs;H83;2;20;77416440;78221205;804765
Jacobs;H83;2;104;80262318;86164251;5901933
Jacobs;H83;2;16;119450094;120383406;933312
Jacobs;H83;2;18;122301320;123573014;1271694
Jacobs;H83;2;34;127306102;129196314;1890212
Jacobs;H83;2;71;131649580;135136548;3486968
Jacobs;H83;2;21;144603941;145745763;1141822
Jacobs;H83;2;16;148986290;149553962;567672
Jacobs;H83;2;34;155064316;156881594;1817278
Jacobs;H83;2;15;170218116;171206036;987920
Jacobs;H83;2;59;186306661;189895425;3588764
Jacobs;H83;2;40;212232636;215251657;3019021
Jacobs;H83;2;64;215844761;221399780;5555019
Jacobs;H83;2;24;231069887;232414241;1344354
Jacobs;H83;2;15;233988816;234937102;948286
Jacobs;H83;2;27;239564082;241057841;1493759
Jacobs;H83;2;57;244129054;247079021;2949967
Jacobs;H83;10;56;13112312;16222665;3110353
Jacobs;H83;10;15;17609318;18389301;779983
Jacobs;H83;10;23;22454477;23642798;1188321
Jacobs;H83;10;111;24977576;30849548;5871972
Jacobs;H83;10;201;32773769;45845544;13071775
Jacobs;H83;10;159;48972916;58031444;9058528
Jacobs;H83;10;15;59776861;60578383;801522
Jacobs;H83;10;27;62729605;65354102;2624497
Jacobs;H83;10;36;75599218;77364701;1765483
Jacobs;H83;24;47;24925070;28511321;3586251
Jacobs;H83;24;19;40193947;42027686;1833739
Jacobs;H84;2;23;15477809;16774412;1296603
Jacobs;H84;2;23;21789864;22860326;1070462
Jacobs;H84;2;58;26737340;30708966;3971626
Jacobs;H84;2;255;35260588;51384849;16124261
Jacobs;H84;2;72;53986551;57495366;3508815
Jacobs;H84;2;36;79183271;80967126;1783855
Jacobs;H84;2;53;83424768;86582074;3157306
Jacobs;H84;2;16;94894157;95731895;837738
Jacobs;H84;2;22;122001925;123541288;1539363
Jacobs;H84;2;40;142709866;145090781;2380915
Jacobs;H84;2;18;165399749;166276060;876311
Jacobs;H84;2;28;175305722;177124764;1819042
Jacobs;H84;2;31;182286302;183830160;1543858
Jacobs;H84;2;54;190742274;193374050;2631776
Jacobs;H84;2;50;211512445;215251657;3739212
Jacobs;H84;2;52;215844761;220852308;5007547
Jacobs;H84;2;232;229397259;242738945;13341686
Jacobs;H84;10;19;2329436;3333520;1004084
Jacobs;H84;10;15;8564410;9353873;789463
Jacobs;H84;10;17;14007878;14856146;848268
Jacobs;H84;10;51;19390547;22376804;2986257
Jacobs;H84;10;128;25827394;32637918;6810524
Jacobs;H84;10;29;36883392;39489315;2605923
Jacobs;H84;10;19;40105937;40971187;865250
Jacobs;H84;10;18;46618259;47487991;869732
Jacobs;H84;10;40;47662790;49344061;1681271
Jacobs;H84;24;16;4734623;5726120;991497
Jacobs;H84;24;20;23828331;25017904;1189573
Jacobs;H85;2;28;22809937;24157644;1347707
Jacobs;H85;2;18;30492514;31353780;861266
Jacobs;H85;2;28;56066709;57495366;1428657
Jacobs;H85;2;29;65574894;67223689;1648795
Jacobs;H85;2;15;73109758;73839087;729329
Jacobs;H85;2;16;106521892;107227866;705974
Jacobs;H85;2;19;108402458;109394432;991974
Jacobs;H85;2;19;121515740;122918820;1403080
Jacobs;H85;2;46;149768329;152437856;2669527
Jacobs;H85;2;164;155026089;164308657;9282568
Jacobs;H85;2;71;167432552;171485026;4052474
Jacobs;H85;2;31;182286302;183830160;1543858
Jacobs;H85;2;104;187856073;193489164;5633091
Jacobs;H85;2;15;195245620;196397256;1151636
Jacobs;H85;2;17;198875303;199681176;805873
Jacobs;H85;2;15;206346660;207322502;975842
Jacobs;H85;2;60;211512445;215641893;4129448
Jacobs;H85;2;15;217925961;219015064;1089103
Jacobs;H85;2;26;219847222;221354646;1507424
Jacobs;H85;2;56;226784844;229721318;2936474
Jacobs;H85;2;18;231424947;232414241;989294
Jacobs;H85;2;18;233988816;235032427;1043611
Jacobs;H85;2;64;236221140;239971864;3750724
Jacobs;H85;10;26;2277631;3541347;1263716
Jacobs;H85;10;30;11553765;13428227;1874462
Jacobs;H85;10;105;14523808;20584964;6061156
Jacobs;H85;10;19;21682188;22713402;1031214
Jacobs;H85;10;144;24977576;32637918;7660342
Jacobs;H85;10;29;36883392;39489315;2605923
Jacobs;H85;10;19;40105937;40971187;865250
Jacobs;H85;10;25;48323497;49344061;1020564
Jacobs;H85;10;49;53303637;56665266;3361629
Jacobs;H85;10;43;56914955;59813838;2898883
Jacobs;H85;10;21;61831934;63941191;2109257
Jacobs;H85;10;59;72799573;75682529;2882956
Jacobs;H85;24;74;7615311;12952274;5336963
Jacobs;H89;2;495;2765814;30051860;27286046
Jacobs;H89;2;34;35564869;37991496;2426627
Jacobs;H89;2;22;38155780;39509173;1353393
Jacobs;H89;2;34;51720147;53366034;1645887
Jacobs;H89;2;132;62820094;69890535;7070441
Jacobs;H89;2;24;121796989;123573014;1776025
Jacobs;H89;2;24;140442104;141557795;1115691
Jacobs;H89;2;20;143595306;144672338;1077032
Jacobs;H89;2;22;163790869;164780655;989786
Jacobs;H89;2;355;165226892;187104069;21877177
Jacobs;H89;2;102;193433380;199546123;6112743
Jacobs;H89;2;20;206427786;207694488;1266702
Jacobs;H89;2;150;208935076;219774612;10839536
Jacobs;H89;2;20;220083076;221153389;1070313
Jacobs;H89;2;366;223364912;244066362;20701450
Jacobs;H89;10;62;4324626;8904686;4580060
Jacobs;H89;10;18;13056079;14007878;951799
Jacobs;H89;10;39;14573661;16744641;2170980
Jacobs;H89;10;19;17336717;18389301;1052584
Jacobs;H89;10;20;20934075;22014650;1080575
Jacobs;H89;10;18;36448017;37738237;1290220
Jacobs;H89;10;20;38727795;40071898;1344103
Jacobs;H89;10;23;46618259;47743423;1125164
Jacobs;H89;10;69;49560674;53147209;3586535
Jacobs;H89;10;15;59776861;60578383;801522
Jacobs;H89;24;46;14275553;17307132;3031579
Jacobs;H89;24;71;17996334;24060526;6064192
Jacobs;H89;24;20;33313461;34176391;862930
Jacobs;H90;2;15;4080987;4670884;589897
Jacobs;H90;2;35;9490117;10932216;1442099
Jacobs;H90;2;28;22809937;24157644;1347707
Jacobs;H90;2;18;30492514;31353780;861266
Jacobs;H90;2;19;70664942;71739429;1074487
Jacobs;H90;2;15;73109758;73839087;729329
Jacobs;H90;2;18;91996530;93217367;1220837
Jacobs;H90;2;23;106109303;107227866;1118563
Jacobs;H90;2;15;114411448;115476148;1064700
Jacobs;H90;2;26;121239876;123048197;1808321
Jacobs;H90;2;153;155606280;164308657;8702377
Jacobs;H90;2;33;182989336;184885519;1896183
Jacobs;H90;2;33;186224877;188204145;1979268
Jacobs;H90;2;40;212232636;215251657;3019021
Jacobs;H90;2;19;217653015;219015064;1362049
Jacobs;H90;2;48;219847222;222552458;2705236
Jacobs;H90;2;26;238831242;240085853;1254611
Jacobs;H90;10;21;23262240;24422906;1160666
Jacobs;H90;10;249;30129111;45845544;15716433
Jacobs;H90;10;40;48323497;50290499;1967002
Jacobs;H90;10;38;52101841;54375509;2273668
Jacobs;H90;10;33;56906392;59172145;2265753
Jacobs;H90;10;42;75599218;77795799;2196581
Jacobs;H90;24;22;6468168;7796684;1328516
Jacobs;H90;24;20;16041579;17514108;1472529
Jacobs;H90;24;19;40193947;42027686;1833739
Jacobs;H91;2;99;945715;5940814;4995099
Jacobs;H91;2;38;12083349;13932966;1849617
Jacobs;H91;2;102;17599102;22860326;5261224
Jacobs;H91;2;45;25939009;29305877;3366868
Jacobs;H91;2;20;31641648;32674404;1032756
Jacobs;H91;2;34;51720147;53366034;1645887
Jacobs;H91;2;123;63387842;69890535;6502693
Jacobs;H91;2;85;77200457;81273844;4073387
Jacobs;H91;2;44;81746910;84580673;2833763
Jacobs;H91;2;16;94561848;95129267;567419
Jacobs;H91;2;17;103407822;104281644;873822
Jacobs;H91;2;23;122001925;123573014;1571089
Jacobs;H91;2;18;130145934;131084439;938505
Jacobs;H91;2;15;147910340;148711192;800852
Jacobs;H91;2;21;169752566;171123855;1371289
Jacobs;H91;2;16;183793517;184673171;879654
Jacobs;H91;2;95;222438632;227373381;4934749
Jacobs;H91;2;18;231060457;232022650;962193
Jacobs;H91;2;51;237261566;240085853;2824287
Jacobs;H91;10;27;12339027;14007878;1668851
Jacobs;H91;10;42;17061324;19399049;2337725
Jacobs;H91;10;34;20482744;22376804;1894060
Jacobs;H91;10;46;29806294;31819224;2012930
Jacobs;H91;10;44;36883392;40371812;3488420
Jacobs;H91;10;120;40670358;48243886;7573528
Jacobs;H91;10;39;50743024;52419746;1676722
Jacobs;H91;10;23;55689588;57077569;1387981
Jacobs;H91;10;45;58074623;60964115;2889492
Jacobs;H91;10;19;65931464;66747944;816480
Jacobs;H91;10;55;66966639;70162514;3195875
Jacobs;H91;10;55;71470411;74728587;3258176
Jacobs;H91;10;31;83994730;85674444;1679714
Jacobs;H91;24;25;6891468;8314969;1423501
Jacobs;H91;24;25;8741291;10709974;1968683
Jacobs;H91;24;22;11076801;12817574;1740773
Jacobs;H91;24;128;22377381;31943864;9566483
Jacobs;H92;2;99;945715;5940814;4995099
Jacobs;H92;2;38;12083349;13932966;1849617
Jacobs;H92;2;102;17599102;22860326;5261224
Jacobs;H92;2;45;25939009;29305877;3366868
Jacobs;H92;2;20;31641648;32674404;1032756
Jacobs;H92;2;34;51720147;53366034;1645887
Jacobs;H92;2;123;63387842;69890535;6502693
Jacobs;H92;2;85;77200457;81273844;4073387
Jacobs;H92;2;44;81746910;84580673;2833763
Jacobs;H92;2;16;94561848;95129267;567419
Jacobs;H92;2;17;103407822;104281644;873822
Jacobs;H92;2;23;122001925;123573014;1571089
Jacobs;H92;2;18;130145934;131084439;938505
Jacobs;H92;2;15;147910340;148711192;800852
Jacobs;H92;2;21;169752566;171123855;1371289
Jacobs;H92;2;16;183793517;184673171;879654
Jacobs;H92;2;95;222438632;227373381;4934749
Jacobs;H92;2;18;231060457;232022650;962193
Jacobs;H92;2;51;237261566;240085853;2824287
Jacobs;H92;10;28;12301677;14007878;1706201
Jacobs;H92;10;42;17061324;19399049;2337725
Jacobs;H92;10;34;20482744;22376804;1894060
Jacobs;H92;10;46;29806294;31819224;2012930
Jacobs;H92;10;44;36883392;40371812;3488420
Jacobs;H92;10;72;40670358;45877910;5207552
Jacobs;H92;10;45;46165969;48243886;2077917
Jacobs;H92;10;39;50743024;52419746;1676722
Jacobs;H92;10;23;55689588;57077569;1387981
Jacobs;H92;10;45;58074623;60964115;2889492
Jacobs;H92;10;19;65931464;66747944;816480
Jacobs;H92;10;55;66966639;70162514;3195875
Jacobs;H92;10;55;71470411;74728587;3258176
Jacobs;H92;10;31;83994730;85674444;1679714
Jacobs;H92;24;25;6891468;8314969;1423501
Jacobs;H92;24;25;8741291;10709974;1968683
Jacobs;H92;24;22;11076801;12817574;1740773
Jacobs;H92;24;128;22377381;31943864;9566483
Jacobs;H97;2;52;14402382;17033754;2631372
Jacobs;H97;2;17;20016014;20816743;800729
Jacobs;H97;2;28;22809937;24157644;1347707
Jacobs;H97;2;139;24756265;33270908;8514643
Jacobs;H97;2;106;34484259;41162381;6678122
Jacobs;H97;2;48;54249685;56804497;2554812
Jacobs;H97;2;28;65402955;67012655;1609700
Jacobs;H97;2;17;73046724;73926990;880266
Jacobs;H97;2;36;79183271;80967126;1783855
Jacobs;H97;2;240;83531972;97811722;14279750
Jacobs;H97;2;18;101030254;101709271;679017
Jacobs;H97;2;17;107035638;107690483;654845
Jacobs;H97;2;32;121607287;123688719;2081432
Jacobs;H97;2;18;125352833;126209935;857102
Jacobs;H97;2;24;128510347;129740367;1230020
Jacobs;H97;2;52;131474019;133748186;2274167
Jacobs;H97;2;74;141512548;145693768;4181220
Jacobs;H97;2;49;211512445;215214415;3701970
Jacobs;H97;2;182;227644968;237613535;9968567
Jacobs;H97;2;16;238041313;238899861;858548
Jacobs;H97;10;33;14949320;16744641;1795321
Jacobs;H97;10;27;21584008;22997802;1413794
Jacobs;H97;10;123;23262240;29882404;6620164
Jacobs;H97;10;18;36448017;37738237;1290220
Jacobs;H97;10;20;38727795;40071898;1344103
Jacobs;H97;10;225;41246529;54375509;13128980
Jacobs;H97;10;33;56906392;59172145;2265753
Jacobs;H97;10;15;61401736;62212986;811250
Jacobs;H97;10;41;66017132;68339290;2322158
Jacobs;H97;24;15;16077497;17253902;1176405
Jacobs;H98;2;16;1675016;2515692;840676
Jacobs;H98;2;16;6625835;7347673;721838
Jacobs;H98;2;76;17969084;21928040;3958956
Jacobs;H98;2;28;22809937;24157644;1347707
Jacobs;H98;2;20;24756265;25765503;1009238
Jacobs;H98;2;20;31641648;32674404;1032756
Jacobs;H98;2;44;39586061;42550059;2963998
Jacobs;H98;2;27;49602010;51384849;1782839
Jacobs;H98;2;69;53304271;56804497;3500226
Jacobs;H98;2;16;64771512;65574894;803382
Jacobs;H98;2;34;79225836;80967126;1741290
Jacobs;H98;2;240;83531972;97811722;14279750
Jacobs;H98;2;18;101030254;101709271;679017
Jacobs;H98;2;17;107035638;107690483;654845
Jacobs;H98;2;32;121607287;123688719;2081432
Jacobs;H98;2;18;125352833;126209935;857102
Jacobs;H98;2;30;133459225;135136548;1677323
Jacobs;H98;2;25;136654969;138081646;1426677
Jacobs;H98;2;19;142709866;143864562;1154696
Jacobs;H98;2;16;144931308;145745763;814455
Jacobs;H98;2;37;148986290;150755823;1769533
Jacobs;H98;2;69;150948753;155231390;4282637
Jacobs;H98;2;36;186085351;188204145;2118794
Jacobs;H98;2;59;202088645;204997139;2908494
Jacobs;H98;2;82;208232368;212806608;4574240
Jacobs;H98;2;235;227644968;240684120;13039152
Jacobs;H98;10;16;12376514;13428227;1051713
Jacobs;H98;10;15;14485571;15306798;821227
Jacobs;H98;10;73;30129111;34015474;3886363
Jacobs;H98;10;16;36637311;37738237;1100926
Jacobs;H98;10;20;38727795;40071898;1344103
Jacobs;H98;10;62;41246529;45845544;4599015
Jacobs;H98;10;37;47228374;48972916;1744542
Jacobs;H98;10;40;57089480;59813838;2724358
Jacobs;H98;10;90;62050961;68339290;6288329
Jacobs;H98;10;15;76428043;77101531;673488
Jacobs;H98;24;15;16077497;17253902;1176405
Jacobs;H98;24;20;24846522;26068027;1221505
Jacobs;H99;2;33;544617;2574507;2029890
Jacobs;H99;2;42;3930781;5940814;2010033
Jacobs;H99;2;32;14508559;16125371;1616812
Jacobs;H99;2;28;22809937;24157644;1347707
Jacobs;H99;2;20;24756265;25765503;1009238
Jacobs;H99;2;20;31641648;32674404;1032756
Jacobs;H99;2;26;85539011;86907702;1368691
Jacobs;H99;2;109;93013077;99427585;6414508
Jacobs;H99;2;16;105291364;106302944;1011580
Jacobs;H99;2;16;106975218;107627876;652658
Jacobs;H99;2;27;113014357;115476148;2461791
Jacobs;H99;2;112;121607287;127753578;6146291
Jacobs;H99;2;19;130636386;131682707;1046321
Jacobs;H99;2;93;142298118;147996276;5698158
Jacobs;H99;2;22;151588637;152834616;1245979
Jacobs;H99;2;67;180818063;184760567;3942504
Jacobs;H99;2;25;204175654;205572258;1396604
Jacobs;H99;2;15;206346660;207322502;975842
Jacobs;H99;2;30;211512445;213245108;1732663
Jacobs;H99;2;36;215844761;219774612;3929851
Jacobs;H99;2;26;223647440;224894551;1247111
Jacobs;H99;10;29;11178146;12956525;1778379
Jacobs;H99;10;24;14894636;16222665;1328029
Jacobs;H99;10;129;23262240;30129111;6866871
Jacobs;H99;10;44;36883392;40371812;3488420
Jacobs;H99;10;104;40670358;47487991;6817633
Jacobs;H99;10;25;53898937;55319894;1420957
Jacobs;H99;10;44;58966248;61237051;2270803
Jacobs;H99;10;19;69129301;70061445;932144
Jacobs;H99;10;33;74078020;75620051;1542031
Jacobs;H99;24;23;7454516;8579698;1125182
Jacobs;H99;24;90;15551549;22769125;7217576
Jacobs;H99;24;53;28877449;32552648;3675199
Jacobs;H99;24;57;37613659;41924374;4310715
Jacobs;H100;2;52;1606489;4166902;2560413
Jacobs;H100;2;17;20016014;20816743;800729
Jacobs;H100;2;76;22396321;26480124;4083803
Jacobs;H100;2;91;45658202;51384849;5726647
Jacobs;H100;2;52;54135888;56804497;2668609
Jacobs;H100;2;28;65402955;67012655;1609700
Jacobs;H100;2;22;72875158;74090507;1215349
Jacobs;H100;2;103;79017511;84802665;5785154
Jacobs;H100;2;74;84938566;88789712;3851146
Jacobs;H100;2;18;91996530;93217367;1220837
Jacobs;H100;2;47;107035638;109132360;2096722
Jacobs;H100;2;21;121796989;123494681;1697692
Jacobs;H100;2;54;131474019;133942420;2468401
Jacobs;H100;2;51;139427894;141971484;2543590
Jacobs;H100;2;43;145994402;148711192;2716790
Jacobs;H100;2;15;170218116;171206036;987920
Jacobs;H100;2;16;198262211;198967974;705763
Jacobs;H100;2;18;215443702;217457102;2013400
Jacobs;H100;2;19;221216169;222027261;811092
Jacobs;H100;2;97;229248722;235032427;5783705
Jacobs;H100;2;26;247245173;248799264;1554091
Jacobs;H100;10;15;3499526;4405111;905585
Jacobs;H100;10;80;18737350;23256944;4519594
Jacobs;H100;10;283;30072709;47487991;17415282
Jacobs;H100;10;20;67493967;68757883;1263916
Jacobs;H100;10;34;74111393;75746175;1634782
Jacobs;H100;10;65;82126706;85596458;3469752
Jacobs;H100;24;74;11451480;16811910;5360430
Jacobs;H100;24;19;21392558;22855134;1462576
Jacobs;H100;24;42;24314975;27613295;3298320
Jacobs;H100;24;16;33313461;33953578;640117
Jacobs;H105;2;35;1645676;3337073;1691397
Jacobs;H105;2;71;10887825;14837808;3949983
Jacobs;H105;2;120;17969084;24157644;6188560
Jacobs;H105;2;20;24756265;25765503;1009238
Jacobs;H105;2;20;31641648;32674404;1032756
Jacobs;H105;2;52;54135888;56804497;2668609
Jacobs;H105;2;28;65402955;67012655;1609700
Jacobs;H105;2;70;69880623;74090507;4209884
Jacobs;H105;2;103;79017511;84802665;5785154
Jacobs;H105;2;74;84938566;88789712;3851146
Jacobs;H105;2;18;91996530;93217367;1220837
Jacobs;H105;2;71;103618164;107690483;4072319
Jacobs;H105;2;15;116953479;117485350;531871
Jacobs;H105;2;20;122001925;123494681;1492756
Jacobs;H105;2;27;129537914;131084439;1546525
Jacobs;H105;2;21;131474019;132323750;849731
Jacobs;H105;2;63;139427894;142593638;3165744
Jacobs;H105;2;436;143595306;168719169;25123863
Jacobs;H105;2;131;171206036;179122335;7916299
Jacobs;H105;2;15;182286302;182923305;637003
Jacobs;H105;2;81;187856073;192288626;4432553
Jacobs;H105;2;32;194853812;197093416;2239604
Jacobs;H105;2;39;199432096;201797379;2365283
Jacobs;H105;2;18;205244432;206276753;1032321
Jacobs;H105;2;15;207971469;208671645;700176
Jacobs;H105;2;183;211512445;224077986;12565541
Jacobs;H105;10;17;14007878;14856146;848268
Jacobs;H105;10;48;30129111;32637918;2508807
Jacobs;H105;10;189;36637311;48775457;12138146
Jacobs;H105;10;26;67238073;68757883;1519810
Jacobs;H105;10;40;82069900;84029946;1960046
Jacobs;H105;24;74;11451480;16811910;5360430
Jacobs;H106;2;15;26572518;27453783;881265
Jacobs;H106;2;18;35302706;36122230;819524
Jacobs;H106;2;289;54135888;69079036;14943148
Jacobs;H106;2;54;93152913;96022899;2869986
Jacobs;H106;2;31;107510683;108787194;1276511
Jacobs;H106;2;145;119490716;127173649;7682933
Jacobs;H106;2;18;130009715;130965527;955812
Jacobs;H106;2;45;152437856;155231390;2793534
Jacobs;H106;2;17;161832617;162492078;659461
Jacobs;H106;2;88;180818063;186306661;5488598
Jacobs;H106;2;15;190742274;191402600;660326
Jacobs;H106;2;15;193197692;193999697;802005
Jacobs;H106;2;16;198563117;199195240;632123
Jacobs;H106;2;49;234808295;237165096;2356801
Jacobs;H106;2;17;238831242;239616700;785458
Jacobs;H106;10;17;14007878;14856146;848268
Jacobs;H106;10;29;36883392;39489315;2605923
Jacobs;H106;10;19;40105937;40971187;865250
Jacobs;H106;10;18;46618259;47487991;869732
Jacobs;H106;10;40;47662790;49344061;1681271
Jacobs;H106;10;21;52101841;53147209;1045368
Jacobs;H106;10;16;67307992;68271380;963388
Jacobs;H106;10;23;74631551;75778400;1146849
Jacobs;H106;24;20;5978910;6976657;997747
Jacobs;H106;24;28;8741291;11007102;2265811
Jacobs;H106;24;15;12335936;13558686;1222750
Jacobs;H106;24;86;16041579;23184425;7142846
Jacobs;H107;2;188;4080987;14272947;10191960
Jacobs;H107;2;44;24966147;27546603;2580456
Jacobs;H107;2;35;51720147;53415584;1695437
Jacobs;H107;2;260;53986551;67126344;13139793
Jacobs;H107;2;20;70664942;71793127;1128185
Jacobs;H107;2;28;73475221;75042274;1567053
Jacobs;H107;2;102;84054194;90362958;6308764
Jacobs;H107;2;31;90752876;92213984;1461108
Jacobs;H107;2;20;98270309;99487592;1217283
Jacobs;H107;2;20;113897647;115476148;1578501
Jacobs;H107;2;21;120609452;121455578;846126
Jacobs;H107;2;30;121607287;123644129;2036842
Jacobs;H107;2;24;132635669;133655932;1020263
Jacobs;H107;2;21;141512548;142593638;1081090
Jacobs;H107;2;81;156555652;161570453;5014801
Jacobs;H107;2;48;182286302;184885519;2599217
Jacobs;H107;2;39;199432096;201797379;2365283
Jacobs;H107;2;16;215443702;216807667;1363965
Jacobs;H107;2;18;228130504;228977129;846625
Jacobs;H107;2;15;236541718;237613535;1071817
Jacobs;H107;10;16;12376514;13428227;1051713
Jacobs;H107;10;15;14485571;15306798;821227
Jacobs;H107;10;123;23262240;29882404;6620164
Jacobs;H107;10;18;36448017;37738237;1290220
Jacobs;H107;10;20;38727795;40071898;1344103
Jacobs;H107;10;140;41246529;49560674;8314145
Jacobs;H107;10;40;57089480;59813838;2724358
Jacobs;H107;10;41;66017132;68339290;2322158
Jacobs;H107;10;167;74631551;83242711;8611160
Jacobs;H107;10;27;84100127;85596458;1496331
Jacobs;H107;24;28;8741291;11007102;2265811
Jacobs;H107;24;72;16077497;21910840;5833343
Jacobs;H107;24;24;33056732;34176391;1119659
Jacobs;H113;2;15;24966147;25765503;799356
Jacobs;H113;2;176;27311358;38334113;11022755
Jacobs;H113;2;38;39989047;42550059;2561012
Jacobs;H113;2;18;51720147;52585897;865750
Jacobs;H113;2;64;63387842;66608553;3220711
Jacobs;H113;2;33;68216266;69890535;1674269
Jacobs;H113;2;22;75644823;76829310;1184487
Jacobs;H113;2;66;77918896;81273844;3354948
Jacobs;H113;2;54;93152913;96022899;2869986
Jacobs;H113;2;17;103407822;104281644;873822
Jacobs;H113;2;20;140158515;141180010;1021495
Jacobs;H113;2;16;143847759;144615833;768074
Jacobs;H113;2;37;148986290;150755823;1769533
Jacobs;H113;2;107;150948753;157367793;6419040
Jacobs;H113;2;15;157697393;158665480;968087
Jacobs;H113;2;17;186085351;187065342;979991
Jacobs;H113;2;81;187856073;192288626;4432553
Jacobs;H113;2;32;194853812;197093416;2239604
Jacobs;H113;2;39;199432096;201797379;2365283
Jacobs;H113;2;43;205244432;207747048;2502616
Jacobs;H113;2;149;208232368;218592494;10360126
Jacobs;H113;2;184;231069887;241543820;10473933
Jacobs;H113;10;17;11184964;12019649;834685
Jacobs;H113;10;17;14007878;14856146;848268
Jacobs;H113;10;48;30129111;32637918;2508807
Jacobs;H113;10;249;36637311;51921300;15283989
Jacobs;H113;10;40;57089480;59813838;2724358
Jacobs;H113;10;29;66779341;68597311;1817970
Jacobs;H113;10;15;76428043;77101531;673488
Jacobs;H113;24;61;37349126;42027686;4678560
Jacobs;H114;2;76;1606489;5215635;3609146
Jacobs;H114;2;44;5798140;8518359;2720219
Jacobs;H114;2;148;21979508;30849683;8870175
Jacobs;H114;2;45;35582012;38744795;3162783
Jacobs;H114;2;15;39198369;40023789;825420
Jacobs;H114;2;16;52327990;53043790;715800
Jacobs;H114;2;19;53986551;54687816;701265
Jacobs;H114;2;22;72875158;74090507;1215349
Jacobs;H114;2;104;79000514;84802665;5802151
Jacobs;H114;2;74;84938566;88789712;3851146
Jacobs;H114;2;18;91996530;93217367;1220837
Jacobs;H114;2;352;101171470;123644129;22472659
Jacobs;H114;2;15;129831656;130673052;841396
Jacobs;H114;2;38;133272817;135451498;2178681
Jacobs;H114;2;43;145994402;148711192;2716790
Jacobs;H114;2;15;170218116;171206036;987920
Jacobs;H114;2;16;198262211;198967974;705763
Jacobs;H114;2;18;215443702;217457102;2013400
Jacobs;H114;2;19;221216169;222027261;811092
Jacobs;H114;2;97;229248722;235032427;5783705
Jacobs;H114;2;15;236783616;237822440;1038824
Jacobs;H114;2;15;245309611;246317098;1007487
Jacobs;H114;10;46;12231314;14856146;2624832
Jacobs;H114;10;41;21126901;23256944;2130043
Jacobs;H114;10;48;30129111;32637918;2508807
Jacobs;H114;10;29;36883392;39489315;2605923
Jacobs;H114;10;19;40105937;40971187;865250
Jacobs;H114;10;18;46618259;47487991;869732
Jacobs;H114;10;40;47662790;49344061;1681271
Jacobs;H114;10;20;54459673;55726976;1267303
Jacobs;H114;10;145;56100245;65768192;9667947
Jacobs;H114;10;15;68944509;69603264;658755
Jacobs;H114;10;15;72510364;73238801;728437
Jacobs;H114;10;46;73603634;75746175;2142541
Jacobs;H114;10;39;82590071;84537988;1947917
Jacobs;H114;24;32;11076801;13702846;2626045
Jacobs;H115;2;70;1645676;5039528;3393852
Jacobs;H115;2;17;20016014;20816743;800729
Jacobs;H115;2;16;52327990;53043790;715800
Jacobs;H115;2;19;53986551;54687816;701265
Jacobs;H115;2;218;56039866;67168555;11128689
Jacobs;H115;2;64;72875158;76732322;3857164
Jacobs;H115;2;74;84640849;88553200;3912351
Jacobs;H115;2;18;91996530;93217367;1220837
Jacobs;H115;2;131;96309972;104101891;7791919
Jacobs;H115;2;24;118134501;119654696;1520195
Jacobs;H115;2;23;122001925;123573014;1571089
Jacobs;H115;2;18;126622908;127390949;768041
Jacobs;H115;2;43;130145934;132323750;2177816
Jacobs;H115;2;51;139427894;141971484;2543590
Jacobs;H115;2;22;154579541;155797260;1217719
Jacobs;H115;2;81;167736523;172424726;4688203
Jacobs;H115;2;15;190574847;191307142;732295
Jacobs;H115;2;18;215443702;217457102;2013400
Jacobs;H115;2;18;217719922;219015064;1295142
Jacobs;H115;2;26;219847222;221354646;1507424
Jacobs;H115;10;15;6551668;8114054;1562386
Jacobs;H115;10;18;33723894;34489447;765553
Jacobs;H115;10;29;36883392;39489315;2605923
Jacobs;H115;10;17;58143024;59691651;1548627
Jacobs;H115;10;30;67493967;69311273;1817306
Jacobs;H115;10;69;74111393;77556267;3444874
Jacobs;H115;24;15;16077497;17253902;1176405
Jacobs;H115;24;72;26493858;31899729;5405871
Jacobs;H116;2;28;1675016;2991783;1316767
Jacobs;H116;2;20;4080987;4835268;754281
Jacobs;H116;2;15;20016014;20690263;674249
Jacobs;H116;2;15;43439988;44133953;693965
Jacobs;H116;2;34;51720147;53366034;1645887
Jacobs;H116;2;50;55908488;58123258;2214770
Jacobs;H116;2;28;65402955;67012655;1609700
Jacobs;H116;2;64;79000514;82192970;3192456
Jacobs;H116;2;88;84054194;88789712;4735518
Jacobs;H116;2;16;94894157;95731895;837738
Jacobs;H116;2;194;103331488;116534114;13202626
Jacobs;H116;2;27;121734938;123644129;1909191
Jacobs;H116;2;40;125273857;127088467;1814610
Jacobs;H116;2;27;127495017;129045322;1550305
Jacobs;H116;2;15;147910340;148711192;800852
Jacobs;H116;2;33;155026089;156798220;1772131
Jacobs;H116;2;20;157031272;158187310;1156038
Jacobs;H116;2;15;170218116;171206036;987920
Jacobs;H116;2;21;198116050;199020889;904839
Jacobs;H116;2;42;199225518;201797379;2571861
Jacobs;H116;2;227;202088645;215251657;13163012
Jacobs;H116;10;15;10155086;10839165;684079
Jacobs;H116;10;82;17481523;22376804;4895281
Jacobs;H116;10;46;29806294;31819224;2012930
Jacobs;H116;10;15;33986642;34603291;616649
Jacobs;H116;10;35;36637311;39489315;2852004
Jacobs;H116;10;130;56946876;65768192;8821316
Jacobs;H116;10;52;67238073;70162514;2924441
Jacobs;H116;10;55;71470411;74728587;3258176
Jacobs;H116;24;99;29375887;36160755;6784868
Jacobs;H26;2;16;5798140;6740866;942726
Jacobs;H26;2;18;7433654;8910387;1476733
Jacobs;H26;2;107;10376684;16096373;5719689
Jacobs;H26;2;19;53986551;54687816;701265
Jacobs;H26;2;112;68216266;74824143;6607877
Jacobs;H26;2;54;84938566;87916949;2978383
Jacobs;H26;2;49;91063757;93856462;2792705
Jacobs;H26;2;101;117369115;123446725;6077610
Jacobs;H26;2;15;124533614;125164918;631304
Jacobs;H26;2;18;133272817;134301618;1028801
Jacobs;H26;2;36;138618372;140442104;1823732
Jacobs;H26;2;67;140937497;144615833;3678336
Jacobs;H26;2;18;163695948;164516447;820499
Jacobs;H26;2;15;170218116;171206036;987920
Jacobs;H26;2;43;205223167;207694488;2471321
Jacobs;H26;2;40;212232636;215251657;3019021
Jacobs;H26;2;51;215994089;220852308;4858219
Jacobs;H26;2;22;226617529;227781732;1164203
Jacobs;H26;2;44;231069887;233623788;2553901
Jacobs;H26;10;67;4518697;9416750;4898053
Jacobs;H26;10;48;15018558;17748924;2730366
Jacobs;H26;10;17;26350351;27365899;1015548
Jacobs;H26;10;16;33919791;34603291;683500
Jacobs;H26;10;32;36770781;39489315;2718534
Jacobs;H26;10;30;42731359;45133795;2402436
Jacobs;H26;10;21;52101841;53147209;1045368
Jacobs;H26;10;52;55689588;59172145;3482557
Jacobs;H26;10;31;67493967;69357196;1863229
Jacobs;H26;24;73;16077497;22222030;6144533
Jacobs;H26;24;33;24314975;26681408;2366433
Jacobs;H32;2;109;158066;6092514;5934448
Jacobs;H32;2;66;8180894;11697656;3516762
Jacobs;H32;2;18;40839676;42000792;1161116
Jacobs;H32;2;17;110875234;112943535;2068301
Jacobs;H32;2;22;114411448;115784285;1372837
Jacobs;H32;2;18;115887593;117115355;1227762
Jacobs;H32;2;32;121515740;123644129;2128389
Jacobs;H32;2;60;134979525;138318697;3339172
Jacobs;H32;2;34;152160860;154331314;2170454
Jacobs;H32;10;19;21811328;22865153;1053825
Jacobs;H32;10;69;29202499;32637918;3435419
Jacobs;H32;10;44;36883392;40371812;3488420
Jacobs;H32;10;120;40670358;48243886;7573528
Jacobs;H32;10;22;50743024;51659456;916432
Jacobs;H32;10;84;52388827;57485800;5096973
Jacobs;H32;10;52;65895391;68757883;2862492
Jacobs;H32;10;136;71470411;79035505;7565094
Jacobs;H32;10;26;83994730;85460556;1465826
Jacobs;H32;24;31;17307132;19741398;2434266
Jacobs;H32;24;21;24776080;26068027;1291947
Jacobs;H32;24;15;31899729;32598869;699140
Navajo-Churro;H38;2;20;19145768;20157007;1011239
Navajo-Churro;H38;2;16;54086367;54744188;657821
Navajo-Churro;H38;2;20;72769457;73839087;1069630
Navajo-Churro;H38;2;16;113014357;114558942;1544585
Navajo-Churro;H38;2;22;131649580;132526868;877288
Navajo-Churro;H38;2;22;166839484;168068688;1229204
Navajo-Churro;H38;10;18;7430510;9003380;1572870
Navajo-Churro;H38;10;17;11027862;11920339;892477
Navajo-Churro;H38;10;16;26122461;27100665;978204
Navajo-Churro;H38;10;16;66177646;66966639;788993
Navajo-Churro;H38;10;17;77868642;78682047;813405
Navajo-Churro;H38;24;17;1807272;3031957;1224685
Navajo-Churro;H38;24;15;33225361;33879086;653725
Navajo-Churro;H44;2;16;52731947;53563082;831135
Navajo-Churro;H44;2;56;53797807;56521561;2723754
Navajo-Churro;H44;2;16;81407809;82013700;605891
Navajo-Churro;H44;2;16;113014357;114558942;1544585
Navajo-Churro;H44;2;23;148274554;149451928;1177374
Navajo-Churro;H44;2;664;160549720;199626176;39076456
Navajo-Churro;H44;2;22;234119904;235225978;1106074
Navajo-Churro;H44;2;15;235347013;235857471;510458
Navajo-Churro;H44;2;16;236398303;237488816;1090513
Navajo-Churro;H44;10;109;24187107;29882404;5695297
Navajo-Churro;H44;10;21;35306379;36448017;1141638
Navajo-Churro;H44;10;23;40105937;41246529;1140592
Navajo-Churro;H44;10;31;56845960;58966248;2120288
Navajo-Churro;H56;2;74;158066;4370486;4212420
Navajo-Churro;H56;2;15;50002207;51012330;1010123
Navajo-Churro;H56;2;172;86057456;95965733;9908277
Navajo-Churro;H56;2;16;113014357;114558942;1544585
Navajo-Churro;H56;2;19;178045098;179122335;1077237
Navajo-Churro;H56;2;16;200897370;201746518;849148
Navajo-Churro;H56;2;101;209994504;217457102;7462598
Navajo-Churro;H56;10;25;33648969;34711242;1062273
Navajo-Churro;H56;10;15;36526839;37243595;716756
Navajo-Churro;H56;10;23;43647988;44929212;1281224
Navajo-Churro;H56;10;15;84297326;84977613;680287
Jacobs;H50;2;20;4080987;4835268;754281
Jacobs;H50;2;80;6149666;10649928;4500262
Jacobs;H50;2;19;30109974;31144311;1034337
Jacobs;H50;2;15;46598180;48112634;1514454
Jacobs;H50;2;75;55160910;58830280;3669370
Jacobs;H50;2;21;65402955;66608553;1205598
Jacobs;H50;2;94;70664942;76142734;5477792
Jacobs;H50;2;94;92631842;98008059;5376217
Jacobs;H50;2;360;98817919;121330712;22512793
Jacobs;H50;2;26;121607287;123494681;1887394
Jacobs;H50;2;39;128510347;130673052;2162705
Jacobs;H50;2;21;131474019;132323750;849731
Jacobs;H50;2;25;136654969;138081646;1426677
Jacobs;H50;2;418;175936054;201514161;25578107
Jacobs;H50;2;17;203989901;204902549;912648
Jacobs;H50;2;75;230505362;235032427;4527065
Jacobs;H50;10;24;18263050;19689245;1426195
Jacobs;H50;10;30;21431009;22997802;1566793
Jacobs;H50;10;27;31819224;33648969;1829745
Jacobs;H50;10;35;33885776;35528316;1642540
Jacobs;H50;10;29;36883392;39489315;2605923
Jacobs;H50;10;19;40105937;40971187;865250
Jacobs;H50;10;18;46618259;47487991;869732
Jacobs;H50;10;18;50632207;51490237;858030
Jacobs;H50;10;86;55689588;60964115;5274527
Jacobs;H50;10;18;79746530;80581510;834980
Jacobs;H50;24;27;4000350;5874652;1874302
Jacobs;H50;24;52;5978910;8842899;2863989
Jacobs;H50;24;168;12065734;24859938;12794204
Jacobs;H50;24;17;32598869;33503397;904528
Jacobs;H27;2;406;158066;22144624;21986558
Jacobs;H27;2;17;40875507;42000792;1125285
Jacobs;H27;2;33;68216266;69890535;1674269
Jacobs;H27;2;15;73109758;73839087;729329
Jacobs;H27;2;130;84640849;92162531;7521682
Jacobs;H27;2;72;96566325;100951258;4384933
Jacobs;H27;2;17;103407822;104281644;873822
Jacobs;H27;2;23;122001925;123573014;1571089
Jacobs;H27;2;54;131474019;133942420;2468401
Jacobs;H27;2;18;163695948;164516447;820499
Jacobs;H27;2;15;170218116;171206036;987920
Jacobs;H27;2;45;186193337;188826201;2632864
Jacobs;H27;2;120;189799453;196669044;6869591
Jacobs;H27;2;15;206886750;207694488;807738
Jacobs;H27;2;163;209050239;220852308;11802069
Jacobs;H27;2;17;227127050;228074336;947286
Jacobs;H27;10;21;8652290;9756279;1103989
Jacobs;H27;10;18;13056079;14007878;951799
Jacobs;H27;10;39;14573661;16744641;2170980
Jacobs;H27;10;17;20329835;21309973;980138
Jacobs;H27;10;157;36883392;47582885;10699493
Jacobs;H27;10;25;52768972;54459673;1690701
Jacobs;H27;10;19;65931464;66747944;816480
Jacobs;H27;10;20;67493967;68757883;1263916
Jacobs;H27;10;43;75314642;77411116;2096474
Jacobs;H27;24;63;15367865;20406106;5038241
Jacobs;H27;24;17;36962278;37808477;846199
Navajo-Churro;H33;2;27;23366203;24839164;1472961
Navajo-Churro;H33;2;24;69660591;71218360;1557769
Navajo-Churro;H33;2;24;99302002;100753683;1451681
Navajo-Churro;H33;2;15;102413838;103237040;823202
Navajo-Churro;H33;2;60;106686708;109420304;2733596
Navajo-Churro;H33;2;280;116961397;132071815;15110418
Navajo-Churro;H33;2;29;133655932;135446006;1790074
Navajo-Churro;H33;2;19;141192562;142123229;930667
Navajo-Churro;H33;2;22;149451928;150532984;1081056
Navajo-Churro;H33;2;22;159122199;160549720;1427521
Navajo-Churro;H33;2;30;182124730;183679720;1554990
Navajo-Churro;H33;2;15;204726565;205454966;728401
Navajo-Churro;H33;2;16;211068237;211735126;666889
Navajo-Churro;H33;2;19;215594803;217736927;2142124
Navajo-Churro;H33;2;16;222552458;223184373;631915
Navajo-Churro;H33;2;53;223812677;226569909;2757232
Navajo-Churro;H33;2;19;242619137;243490742;871605
Navajo-Churro;H33;10;15;28502457;29304176;801719
Navajo-Churro;H33;10;22;43417893;44708676;1290783
Navajo-Churro;H33;10;18;48078785;48804938;726153
Navajo-Churro;H33;10;34;49914859;51782008;1867149
Navajo-Churro;H33;10;15;59298205;60125957;827752
Navajo-Churro;H33;10;53;71470411;74631551;3161140
Navajo-Churro;H33;10;17;81307769;82010502;702733
Navajo-Churro;H33;10;32;82753442;84297326;1543884
Navajo-Churro;H33;24;28;32623905;34113252;1489347
Navajo-Churro;H39;2;32;14359717;15897797;1538080
Navajo-Churro;H39;2;15;20046763;20767838;721075
Navajo-Churro;H39;2;333;75745623;94561848;18816225
Navajo-Churro;H39;2;16;102667770;103629915;962145
Navajo-Churro;H39;2;230;105595874;120634348;15038474
Navajo-Churro;H39;2;17;121484489;122429181;944692
Navajo-Churro;H39;2;18;160867028;161748310;881282
Navajo-Churro;H39;2;17;189799453;190643587;844134
Navajo-Churro;H39;2;19;223762044;224665736;903692
Navajo-Churro;H39;10;25;42242344;44495989;2253645
Navajo-Churro;H39;24;18;9865712;11526475;1660763
Navajo-Churro;H45;2;440;158066;23881589;23723523
Navajo-Churro;H45;2;19;65163534;66143622;980088
Navajo-Churro;H45;2;19;71387561;72460390;1072829
Navajo-Churro;H45;2;16;80343267;80942245;598978
Navajo-Churro;H45;2;66;92132718;95965733;3833015
Navajo-Churro;H45;2;21;151588637;152773944;1185307
Navajo-Churro;H45;2;16;153937847;154723424;785577
Navajo-Churro;H45;2;23;158749266;160185941;1436675
Navajo-Churro;H45;2;20;194376158;195861753;1485595
Navajo-Churro;H45;2;19;215680487;217925961;2245474
Navajo-Churro;H45;2;37;228897020;230926690;2029670
Navajo-Churro;H45;10;97;2769146;9416750;6647604
Navajo-Churro;H45;24;18;9460076;11326321;1866245
Navajo-Churro;H45;24;36;20734455;23689555;2955100
Navajo-Churro;H45;24;25;25523363;27613295;2089932
Navajo-Churro;H45;24;20;36938439;37965791;1027352
Jacobs;H51;2;86;158066;4835268;4677202
Jacobs;H51;2;98;7433654;13078663;5645009
Jacobs;H51;2;27;17033754;18555382;1521628
Jacobs;H51;2;28;22809937;24157644;1347707
Jacobs;H51;2;83;24756265;30109974;5353709
Jacobs;H51;2;35;51720147;53415584;1695437
Jacobs;H51;2;46;53986551;56154368;2167817
Jacobs;H51;2;126;59972946;66608553;6635607
Jacobs;H51;2;21;70664942;71844617;1179675
Jacobs;H51;2;47;107035638;109132360;2096722
Jacobs;H51;2;21;121796989;123494681;1697692
Jacobs;H51;2;51;132635669;135391568;2755899
Jacobs;H51;2;25;136654969;138081646;1426677
Jacobs;H51;2;89;142656135;148013217;5357082
Jacobs;H51;2;17;152048567;153128082;1079515
Jacobs;H51;2;22;159437585;160748450;1310865
Jacobs;H51;2;248;186193337;200658492;14465155
Jacobs;H51;2;18;205244432;206276753;1032321
Jacobs;H51;2;178;208232368;220903491;12671123
Jacobs;H51;2;32;221245334;222800960;1555626
Jacobs;H51;2;61;232957928;236120162;3162234
Jacobs;H51;10;692;20839740;61065661;40225921
Jacobs;H51;10;16;67307992;68271380;963388
Jacobs;H51;24;134;12036238;22329952;10293714
Jacobs;H57;2;50;1906939;4351718;2444779
Jacobs;H57;2;518;39411236;68412890;29001654
Jacobs;H57;2;20;73508928;74700075;1191147
Jacobs;H57;2;221;90752876;103618164;12865288
Jacobs;H57;2;119;140622573;147650770;7028197
Jacobs;H57;2;128;199432096;206276753;6844657
Jacobs;H57;2;39;208935076;211068237;2133161
Jacobs;H57;2;28;215844761;219015064;3170303
Jacobs;H57;2;17;222919932;223762044;842112
Jacobs;H57;10;17;14007878;14856146;848268
Jacobs;H57;10;48;15018558;17748924;2730366
Jacobs;H57;10;16;20329835;21273163;943328
Jacobs;H57;10;31;32968431;34536188;1567757
Jacobs;H57;10;16;36637311;37738237;1100926
Jacobs;H57;10;34;41802553;44519802;2717249
Jacobs;H57;10;39;50743024;52419746;1676722
Jacobs;H57;10;33;52768972;54955412;2186440
Jacobs;H57;10;124;61831934;70162514;8330580
Jacobs;H57;10;137;71470411;79062231;7591820
Jacobs;H57;24;15;12558998;13761594;1202596
Jacobs;H57;24;96;17040364;24740555;7700191
Jacobs;H57;24;119;33056732;42027686;8970954
Navajo-Churro;H28;2;17;41567516;42668778;1101262
Navajo-Churro;H28;2;20;72769457;73839087;1069630
Navajo-Churro;H28;2;89;80125390;84938566;4813176
Navajo-Churro;H28;2;19;103640034;104876321;1236287
Navajo-Churro;H28;2;27;108235636;109633672;1398036
Navajo-Churro;H28;2;26;129421996;130880304;1458308
Navajo-Churro;H28;2;25;148479250;149553962;1074712
Navajo-Churro;H28;2;15;211151124;211767237;616113
Navajo-Churro;H28;2;35;238249575;240012290;1762715
Navajo-Churro;H28;10;55;30849548;33885776;3036228
Navajo-Churro;H28;10;21;36847123;38751668;1904545
Navajo-Churro;H28;10;23;41420084;43591931;2171847
Navajo-Churro;H28;10;20;75531431;76502321;970890
Navajo-Churro;H28;10;18;83277025;84029946;752921
Navajo-Churro;H28;24;25;21019195;23209530;2190335
Navajo-Churro;H34;2;240;14272947;26932618;12659671
Navajo-Churro;H34;2;24;40931803;42668778;1736975
Navajo-Churro;H34;2;359;75745623;95965733;20220110
Navajo-Churro;H34;2;15;114411448;115476148;1064700
Navajo-Churro;H34;2;595;160549720;195861753;35312033
Navajo-Churro;H34;2;23;202249334;203171974;922640
Navajo-Churro;H34;2;17;214020092;215594803;1574711
Navajo-Churro;H34;2;22;222800960;223856449;1055489
Navajo-Churro;H34;2;110;236398303;243050370;6652067
Navajo-Churro;H34;10;17;9168972;9970267;801295
Navajo-Churro;H34;10;109;24187107;29882404;5695297
Navajo-Churro;H34;10;21;35306379;36448017;1141638
Navajo-Churro;H34;10;23;40105937;41246529;1140592
Navajo-Churro;H34;10;31;56845960;58966248;2120288
Navajo-Churro;H34;10;18;71470411;72901888;1431477
Navajo-Churro;H34;24;20;16041579;17514108;1472529
Navajo-Churro;H34;24;17;25638494;27091483;1452989
Jacobs;H40;2;24;158066;1906939;1748873
Jacobs;H40;2;15;3812405;4456589;644184
Jacobs;H40;2;16;21825858;22493681;667823
Jacobs;H40;2;15;39411236;40151930;740694
Jacobs;H40;2;16;52327990;53043790;715800
Jacobs;H40;2;19;53986551;54687816;701265
Jacobs;H40;2;92;70664942;76044554;5379612
Jacobs;H40;2;387;103407822;127173649;23765827
Jacobs;H40;2;142;133272817;141299872;8027055
Jacobs;H40;2;15;170218116;171206036;987920
Jacobs;H40;2;194;193151043;203989901;10838858
Jacobs;H40;2;17;205305554;206276753;971199
Jacobs;H40;2;47;212232636;215498705;3266069
Jacobs;H40;2;167;215844761;226784844;10940083
Jacobs;H40;2;16;232591652;233623788;1032136
Jacobs;H40;10;18;11178146;12019649;841503
Jacobs;H40;10;51;14894636;17748924;2854288
Jacobs;H40;10;20;22955949;24020844;1064895
Jacobs;H40;10;15;33986642;34603291;616649
Jacobs;H40;10;35;36637311;39489315;2852004
Jacobs;H40;10;18;46618259;47487991;869732
Jacobs;H40;10;44;50265265;52419746;2154481
Jacobs;H40;10;52;55689588;59172145;3482557
Jacobs;H40;10;52;67238073;70162514;2924441
Jacobs;H40;10;107;71470411;77411116;5940705
Jacobs;H40;10;27;77753126;79062231;1309105
Jacobs;H40;24;106;5485098;12550566;7065468
Jacobs;H40;24;69;17040364;22561935;5521571
Jacobs;H40;24;15;34225118;35585230;1360112
Jacobs;H40;24;17;38840214;39735778;895564
Jacobs;H40;24;19;40193947;42027686;1833739
Jacobs;H46;2;134;1645676;8910387;7264711
Jacobs;H46;2;28;22809937;24157644;1347707
Jacobs;H46;2;89;24756265;30589213;5832948
Jacobs;H46;2;40;46219946;49009193;2789247
Jacobs;H46;2;83;53304271;57495366;4191095
Jacobs;H46;2;20;73508928;74700075;1191147
Jacobs;H46;2;45;88992392;92132718;3140326
Jacobs;H46;2;34;93102704;94768669;1665965
Jacobs;H46;2;17;103407822;104281644;873822
Jacobs;H46;2;30;121607287;123644129;2036842
Jacobs;H46;2;69;130636386;134094336;3457950
Jacobs;H46;2;18;134667278;135474064;806786
Jacobs;H46;2;119;140622573;147650770;7028197
Jacobs;H46;2;15;170218116;171206036;987920
Jacobs;H46;2;46;215147086;219015064;3867978
Jacobs;H46;2;17;219847222;220955491;1108269
Jacobs;H46;2;16;222636869;223262207;625338
Jacobs;H46;2;15;236449805;237488816;1039011
Jacobs;H46;2;18;239564082;240647987;1083905
Jacobs;H46;10;31;32968431;34536188;1567757
Jacobs;H46;10;16;36637311;37738237;1100926
Jacobs;H46;10;34;41802553;44519802;2717249
Jacobs;H46;10;39;50743024;52419746;1676722
Jacobs;H46;10;33;52768972;54955412;2186440
Jacobs;H46;10;63;55689588;59813838;4124250
Jacobs;H46;10;25;63706057;65354102;1648045
Jacobs;H46;10;23;67238073;68597311;1359238
Jacobs;H46;10;17;76428043;77210348;782305
Jacobs;H46;10;51;78849033;81397746;2548713
Jacobs;H46;24;61;5485098;8842899;3357801
Jacobs;H46;24;15;16077497;17253902;1176405
Jacobs;H46;24;49;17996334;22222030;4225696
Jacobs;H46;24;20;33313461;34176391;862930
Jacobs;H46;24;16;39300789;40336394;1035605
Navajo-Churro;H52;2;15;35564869;36228409;663540
Navajo-Churro;H52;2;24;50949347;52409379;1460032
Navajo-Churro;H52;2;21;80125390;80942245;816855
Navajo-Churro;H52;2;24;113394834;115525483;2130649
Navajo-Churro;H52;2;21;132341140;133229013;887873
Navajo-Churro;H52;2;16;145044081;145813854;769773
Navajo-Churro;H52;2;15;170218116;171206036;987920
Navajo-Churro;H52;2;15;212806608;213505877;699269
Navajo-Churro;H52;2;18;218418759;219933911;1515152
Navajo-Churro;H52;2;19;227921207;228848890;927683
Navajo-Churro;H52;10;16;9199074;9970267;771193
Navajo-Churro;H52;10;15;11027862;11853718;825856
Navajo-Churro;H52;10;16;13325738;14077091;751353
Navajo-Churro;H52;10;22;29502667;30559444;1056777
Navajo-Churro;H52;10;18;32465060;33582901;1117841
Navajo-Churro;H52;10;18;83277025;84029946;752921
Navajo-Churro;H52;24;25;21019195;23209530;2190335
Navajo-Churro;H58;2;17;4271242;5011935;740693
Navajo-Churro;H58;2;15;16042496;16774412;731916
Navajo-Churro;H58;2;15;72709484;73475221;765737
Navajo-Churro;H58;2;19;103640034;104876321;1236287
Navajo-Churro;H58;2;18;110083416;111172962;1089546
Navajo-Churro;H58;2;21;160907059;161921750;1014691
Navajo-Churro;H58;10;16;9199074;9970267;771193
Navajo-Churro;H58;10;85;25827394;30321628;4494234
Navajo-Churro;H58;10;16;35744011;36653024;909013
Navajo-Churro;H58;24;18;4866988;5951054;1084066
Navajo-Churro;H29;2;43;11449399;13794213;2344814
Navajo-Churro;H29;2;21;33770371;34802714;1032343
Navajo-Churro;H29;2;15;52100951;52790093;689142
Navajo-Churro;H29;2;16;62524786;63447389;922603
Navajo-Churro;H29;2;24;63675988;64741376;1065388
Navajo-Churro;H29;2;25;67387676;68670063;1282387
Navajo-Churro;H29;2;25;86669812;87906063;1236251
Navajo-Churro;H29;2;37;107709004;109633672;1924668
Navajo-Churro;H29;2;19;116465257;117413762;948505
Navajo-Churro;H29;2;66;187836750;191497969;3661219
Navajo-Churro;H29;2;15;215368972;215994089;625117
Navajo-Churro;H29;10;15;18737350;19534616;797266
Navajo-Churro;H29;10;17;33919791;34667432;747641
Navajo-Churro;H29;10;19;77276861;78347774;1070913
Navajo-Churro;H29;24;23;12335936;13980455;1644519
Navajo-Churro;H29;24;107;21629724;29910952;8281228
Jacobs;H35;2;20;10206141;10967299;761158
Jacobs;H35;2;19;39327845;40350901;1023056
Jacobs;H35;2;33;42499181;44430836;1931655
Jacobs;H35;2;158;48816011;57182355;8366344
Jacobs;H35;2;92;70664942;76044554;5379612
Jacobs;H35;2;42;84054194;86582074;2527880
Jacobs;H35;2;29;91143985;92891269;1747284
Jacobs;H35;2;20;109420304;110765081;1344777
Jacobs;H35;2;29;110875234;114279784;3404550
Jacobs;H35;2;23;116534114;117702396;1168282
Jacobs;H35;2;70;122001925;125884996;3883071
Jacobs;H35;2;15;128359488;129109277;749789
Jacobs;H35;2;16;130229606;131084439;854833
Jacobs;H35;2;74;136336816;140442104;4105288
Jacobs;H35;2;48;141299872;144088879;2789007
Jacobs;H35;2;38;145628424;147996276;2367852
Jacobs;H35;2;22;159437585;160748450;1310865
Jacobs;H35;2;192;207575434;220852308;13276874
Jacobs;H35;2;17;227127050;228074336;947286
Jacobs;H35;2;333;228485892;247635266;19149374
Jacobs;H35;10;18;13056079;14007878;951799
Jacobs;H35;10;39;14573661;16744641;2170980
Jacobs;H35;10;17;20329835;21309973;980138
Jacobs;H35;10;29;36883392;39489315;2605923
Jacobs;H35;10;17;46618259;47385192;766933
Jacobs;H35;10;83;50632207;55075006;4442799
Jacobs;H35;10;74;66017132;70162514;4145382
Jacobs;H35;10;52;71470411;74592356;3121945
Jacobs;H35;10;61;74752408;77939102;3186694
Jacobs;H35;24;30;7245176;8842899;1597723
Jacobs;H35;24;19;16077497;17514108;1436611
Jacobs;H35;24;29;29652597;31899729;2247132
Jacobs;H35;24;17;33879086;35216176;1337090
Navajo-Churro;H41;2;32;12636461;14359717;1723256
Navajo-Churro;H41;2;20;53837176;54681929;844753
Navajo-Churro;H41;2;323;66226023;84640849;18414826
Navajo-Churro;H41;2;403;92213984;117702396;25488412
Navajo-Churro;H41;2;18;121734938;123274303;1539365
Navajo-Churro;H41;2;225;139597601;152215629;12618028
Navajo-Churro;H41;2;347;167533866;189117884;21584018
Navajo-Churro;H41;2;19;209901734;210975950;1074216
Navajo-Churro;H41;2;16;218427149;219847222;1420073
Navajo-Churro;H41;2;23;236027912;237488816;1460904
Navajo-Churro;H41;10;41;4405111;7042162;2637051
Navajo-Churro;H41;10;25;37545338;39816919;2271581
Navajo-Churro;H41;10;33;42049970;44651272;2601302
Navajo-Churro;H41;10;15;52419746;53147209;727463
Navajo-Churro;H41;24;20;15893121;17460873;1567752
Navajo-Churro;H41;24;21;20406106;21910840;1504734
Navajo-Churro;H41;24;22;34113252;36076909;1963657
Jacobs;H47;2;79;6092514;10537097;4444583
Jacobs;H47;2;707;34484259;75042274;40558015
Jacobs;H47;2;24;108235636;109394432;1158796
Jacobs;H47;2;21;109766460;111002455;1235995
Jacobs;H47;2;160;117934792;126734704;8799912
Jacobs;H47;2;24;139427894;140518458;1090564
Jacobs;H47;2;15;147910340;148711192;800852
Jacobs;H47;2;22;151588637;152834616;1245979
Jacobs;H47;2;17;164152670;164923059;770389
Jacobs;H47;2;114;206427786;212806608;6378822
Jacobs;H47;2;24;213674776;215641893;1967117
Jacobs;H47;2;18;221245334;222027261;781927
Jacobs;H47;2;15;236347543;237315458;967915
Jacobs;H47;10;99;12019649;17779188;5759539
Jacobs;H47;10;23;18389301;19700851;1311550
Jacobs;H47;10;211;21431009;32637918;11206909
Jacobs;H47;10;18;36448017;37738237;1290220
Jacobs;H47;10;20;38727795;40071898;1344103
Jacobs;H47;10;36;53303637;55726976;2423339
Jacobs;H47;10;69;57089480;61237051;4147571
Jacobs;H47;10;66;74131332;77411116;3279784
Jacobs;H47;24;18;7483090;8379806;896716
Jacobs;H47;24;25;8741291;10709974;1968683
Jacobs;H47;24;90;13299441;19741398;6441957
Navajo-Churro;H53;2;20;3930781;4739830;809049
Navajo-Churro;H53;2;21;6587778;7672558;1084780
Navajo-Churro;H53;2;17;45031982;46146229;1114247
Navajo-Churro;H53;2;16;85589367;86333486;744119
Navajo-Churro;H53;2;16;94761838;95395889;634051
Navajo-Churro;H53;2;141;121299744;128972285;7672541
Navajo-Churro;H53;2;16;129295009;130145934;850925
Navajo-Churro;H53;2;24;131584922;132526868;941946
Navajo-Churro;H53;2;15;136887323;137576137;688814
Navajo-Churro;H53;2;20;144170136;145234800;1064664
Navajo-Churro;H53;2;19;148802744;149609364;806620
Navajo-Churro;H53;2;20;193596846;194853812;1256966
Navajo-Churro;H53;2;20;200044698;201345538;1300840
Navajo-Churro;H53;2;15;201656850;202253568;596718
Navajo-Churro;H53;2;19;212749665;213756591;1006926
Navajo-Churro;H53;2;87;231834142;236347543;4513401
Navajo-Churro;H53;2;20;238041313;239031909;990596
Navajo-Churro;H53;10;34;41910764;44545554;2634790
Navajo-Churro;H53;10;16;69208998;69913567;704569
Navajo-Churro;H53;10;15;74187529;74893559;706030
Navajo-Churro;H53;10;18;85392365;86278436;886071
Navajo-Churro;H53;24;110;6468168;14275553;7807385
Navajo-Churro;H53;24;23;24989534;26759068;1769534
Jacobs;H59;2;88;158066;5039528;4881462
Jacobs;H59;2;121;16416165;22664271;6248106
Jacobs;H59;2;18;40839676;42000792;1161116
Jacobs;H59;2;18;101030254;101709271;679017
Jacobs;H59;2;17;110875234;112943535;2068301
Jacobs;H59;2;22;114411448;115784285;1372837
Jacobs;H59;2;17;115912934;117115355;1202421
Jacobs;H59;2;20;121515740;123048197;1532457
Jacobs;H59;2;121;131834108;138318697;6484589
Jacobs;H59;2;34;152160860;154331314;2170454
Jacobs;H59;2;16;163564272;164411911;847639
Jacobs;H59;2;15;167511192;168264380;753188
Jacobs;H59;2;20;175610830;177124764;1513934
Jacobs;H59;2;48;182286302;184885519;2599217
Jacobs;H59;2;15;190742274;191402600;660326
Jacobs;H59;2;15;207971469;208671645;700176
Jacobs;H59;10;15;10155086;10839165;684079
Jacobs;H59;10;19;20444136;21431009;986873
Jacobs;H59;10;38;36770781;39942731;3171950
Jacobs;H59;10;44;52768972;55726976;2958004
Jacobs;H59;10;69;57089480;61237051;4147571
Jacobs;H59;10;36;68271380;70162514;1891134
Jacobs;H59;10;140;71470411;79188465;7718054
Jacobs;H59;10;75;80519356;84137492;3618136
Jacobs;H59;24;20;18027756;19683887;1656131
Jacobs;H59;24;31;22222030;24591560;2369530
Jacobs;H59;24;15;31899729;32598869;699140
Navajo-Churro;H30;2;16;30785949;31564277;778328
Navajo-Churro;H30;2;16;36122230;37164388;1042158
Navajo-Churro;H30;2;17;41064340;42199949;1135609
Navajo-Churro;H30;2;18;52790093;53725483;935390
Navajo-Churro;H30;2;547;86266274;120426576;34160302
Navajo-Churro;H30;2;17;146616690;147910340;1293650
Navajo-Churro;H30;2;27;164152670;165447554;1294884
Navajo-Churro;H30;2;15;212806608;213505877;699269
Navajo-Churro;H30;2;18;218418759;219933911;1515152
Navajo-Churro;H30;2;19;227921207;228848890;927683
Navajo-Churro;H30;2;20;240477448;241612246;1134798
Navajo-Churro;H30;10;16;27809739;28470083;660344
Navajo-Churro;H30;10;24;35629123;36950734;1321611
Navajo-Churro;H30;10;18;68151686;69208998;1057312
Navajo-Churro;H30;24;16;1527822;2920403;1392581
Navajo-Churro;H30;24;17;18027756;19347886;1320130
Navajo-Churro;H30;24;19;25961188;27680635;1719447
Navajo-Churro;H42;2;25;30173541;31519390;1345849
Navajo-Churro;H42;2;15;35302706;35929894;627188
Navajo-Churro;H42;2;15;48025916;48731082;705166
Navajo-Churro;H42;2;15;52025095;52714676;689581
Navajo-Churro;H42;2;68;67709618;71793127;4083509
Navajo-Churro;H42;2;19;83531972;84732669;1200697
Navajo-Churro;H42;2;17;100147522;100934715;787193
Navajo-Churro;H42;2;19;105769436;106830369;1060933
Navajo-Churro;H42;2;22;183539540;184813524;1273984
Navajo-Churro;H42;2;200;220556620;231069887;10513267
Jacobs;H48;2;16;5798140;6740866;942726
Jacobs;H48;2;83;10376684;14837808;4461124
Jacobs;H48;2;72;67488344;71739429;4251085
Jacobs;H48;2;15;73109758;73839087;729329
Jacobs;H48;2;145;92213984;100951258;8737274
Jacobs;H48;2;17;103407822;104281644;873822
Jacobs;H48;2;23;122001925;123573014;1571089
Jacobs;H48;2;39;139494558;141299872;1805314
Jacobs;H48;2;41;142270405;144615833;2345428
Jacobs;H48;2;15;167511192;168264380;753188
Jacobs;H48;2;16;172745053;173584797;839744
Jacobs;H48;2;39;176369323;178764936;2395613
Jacobs;H48;2;117;193151043;200044698;6893655
Jacobs;H48;2;22;211512445;212806608;1294163
Jacobs;H48;2;24;231069887;232414241;1344354
Jacobs;H48;2;15;239564082;240409281;845199
Jacobs;H48;10;15;6334228;7492074;1157846
Jacobs;H48;10;27;21584008;22997802;1413794
Jacobs;H48;10;110;24977576;30743409;5765833
Jacobs;H48;10;18;35566480;36526839;960359
Jacobs;H48;10;36;36847123;39942731;3095608
Jacobs;H48;10;21;51626765;52419746;792981
Jacobs;H48;10;20;67493967;68757883;1263916
Jacobs;H48;10;43;75314642;77411116;2096474
Jacobs;H48;24;39;10176168;13647199;3471031
Jacobs;H48;24;79;15367865;21629724;6261859
Jacobs;H48;24;25;27739247;29475441;1736194
Jacobs;H54;2;35;10376684;12330936;1954252
Jacobs;H54;2;19;25811615;26932618;1121003
Jacobs;H54;2;37;39198369;41567516;2369147
Jacobs;H54;2;27;74785937;76411172;1625235
Jacobs;H54;2;29;90752876;92132718;1379842
Jacobs;H54;2;47;107035638;109132360;2096722
Jacobs;H54;2;21;121796989;123494681;1697692
Jacobs;H54;2;46;126344239;128843993;2499754
Jacobs;H54;2;31;142709866;144572606;1862740
Jacobs;H54;2;30;153569061;155231390;1662329
Jacobs;H54;2;263;186193337;201496886;15303549
Jacobs;H54;2;61;214005350;219774612;5769262
Jacobs;H54;2;17;227127050;228074336;947286
Jacobs;H54;10;26;2277631;3541347;1263716
Jacobs;H54;10;18;9756279;10629530;873251
Jacobs;H54;10;42;16378011;18737350;2359339
Jacobs;H54;10;22;19096234;20329835;1233601
Jacobs;H54;10;19;22713402;23673666;960264
Jacobs;H54;10;15;33986642;34603291;616649
Jacobs;H54;10;44;36883392;40371812;3488420
Jacobs;H54;10;120;40670358;48243886;7573528
Jacobs;H54;10;73;74078020;77795799;3717779
Jacobs;H54;10;26;84137492;85596458;1458966
Jacobs;H54;24;24;4674353;6101314;1426961
Jacobs;H54;24;135;13170165;23497703;10327538
Jacobs;H54;24;187;26142394;39711452;13569058
Navajo-Churro;H60;2;15;18801493;19281367;479874
Navajo-Churro;H60;2;16;52731947;53563082;831135
Navajo-Churro;H60;2;56;53797807;56521561;2723754
Navajo-Churro;H60;2;75;77328509;80904183;3575674
Navajo-Churro;H60;2;779;84580673;131210129;46629456
Navajo-Churro;H60;2;16;148802744;149539226;736482
Navajo-Churro;H60;2;16;152437856;153569061;1131205
Navajo-Churro;H60;2;29;171485026;173034908;1549882
Navajo-Churro;H60;2;15;189539157;190267950;728793
Navajo-Churro;H60;2;23;197415364;198563117;1147753
Navajo-Churro;H60;2;196;230505362;241649475;11144113
Navajo-Churro;H60;10;16;2407434;3275097;867663
Navajo-Churro;H60;10;38;14137399;16338178;2200779
Navajo-Churro;H60;10;15;17428164;18263050;834886
Navajo-Churro;H60;10;15;32794538;33648969;854431
Navajo-Churro;H60;10;24;35744011;37055676;1311665
Navajo-Churro;H60;10;26;43417893;44929212;1511319
Navajo-Churro;H60;10;17;71470411;72890659;1420248
Navajo-Churro;H60;24;71;16147749;22222030;6074281
Navajo-Churro;H60;24;18;26068027;27739247;1671220
Navajo-Churro;H31;2;15;25125263;26100485;975222
Navajo-Churro;H31;2;59;48333814;51720147;3386333
Navajo-Churro;H31;2;22;54249685;55425163;1175478
Navajo-Churro;H31;2;22;73828642;75042274;1213632
Navajo-Churro;H31;2;16;113014357;114558942;1544585
Navajo-Churro;H31;2;15;168799360;169494537;695177
Navajo-Churro;H31;2;17;229965518;230926690;961172
Navajo-Churro;H31;10;21;46536830;47513384;976554
Navajo-Churro;H31;10;25;49411181;50995309;1584128
Navajo-Churro;H31;10;31;56845960;58966248;2120288
Navajo-Churro;H31;24;22;10208845;12181694;1972849
Navajo-Churro;H31;24;17;31359697;32390507;1030810
Navajo-Churro;H37;2;21;1717596;2756505;1038909
Navajo-Churro;H37;2;19;6625835;7490500;864665
Navajo-Churro;H37;2;70;43109801;47450537;4340736
Navajo-Churro;H37;2;22;73828642;75042274;1213632
Navajo-Churro;H37;2;16;113014357;114558942;1544585
Navajo-Churro;H37;2;24;132208083;133229013;1020930
Navajo-Churro;H37;2;15;168799360;169494537;695177
Navajo-Churro;H37;2;17;229965518;230926690;961172
Navajo-Churro;H37;2;25;243907649;245206162;1298513
Navajo-Churro;H37;10;153;53838664;63808989;9970325
Navajo-Churro;H37;24;17;31359697;32390507;1030810
Navajo-Churro;H43;2;16;63770877;64459393;688516
Navajo-Churro;H43;2;17;67763382;68670063;906681
Navajo-Churro;H43;2;18;121734938;123274303;1539365
Navajo-Churro;H43;2;15;130673052;131584922;911870
Navajo-Churro;H43;2;23;148274554;149451928;1177374
Navajo-Churro;H43;2;1120;160549720;227044476;66494756
Navajo-Churro;H43;10;18;32818994;33843863;1024869
Navajo-Churro;H43;10;19;40371812;41271768;899956
Navajo-Churro;H43;10;30;77276861;78916131;1639270
Navajo-Churro;H49;2;21;6587778;7672558;1084780
Navajo-Churro;H49;2;18;45015658;46146229;1130571
Navajo-Churro;H49;2;18;63770877;64542824;771947
Navajo-Churro;H49;2;17;66543498;67488344;944846
Navajo-Churro;H49;2;15;73828642;74700075;871433
Navajo-Churro;H49;2;16;108264568;108906253;641685
Navajo-Churro;H49;2;18;115476148;116265153;789005
Navajo-Churro;H49;2;18;121607287;123048197;1440910
Navajo-Churro;H49;2;28;124533614;125776688;1243074
Navajo-Churro;H49;2;16;132208083;132904756;696673
Navajo-Churro;H49;2;18;173910913;175124550;1213637
Navajo-Churro;H49;2;16;201430616;202080321;649705
Navajo-Churro;H49;2;101;209994504;217457102;7462598
Navajo-Churro;H49;2;16;242150818;243005095;854277
Navajo-Churro;H49;2;25;243907649;245206162;1298513
Navajo-Churro;H49;10;16;21584008;22454477;870469
Navajo-Churro;H49;10;20;36064927;37055676;990749
Navajo-Churro;H49;10;26;43417893;44929212;1511319
Navajo-Churro;H49;10;56;51490237;54398140;2907903
Navajo-Churro;H49;10;16;78093080;78876406;783326
Navajo-Churro;H49;24;85;7107585;13231049;6123464
Jacobs;H55;2;15;3961544;4556476;594932
Jacobs;H55;2;21;5011935;6003251;991316
Jacobs;H55;2;15;26572518;27453783;881265
Jacobs;H55;2;137;43184130;51529698;8345568
Jacobs;H55;2;16;52327990;53043790;715800
Jacobs;H55;2;19;53986551;54687816;701265
Jacobs;H55;2;21;65402955;66608553;1205598
Jacobs;H55;2;36;68216266;70040931;1824665
Jacobs;H55;2;36;72759408;74824143;2064735
Jacobs;H55;2;98;77200457;81819011;4618554
Jacobs;H55;2;81;92063431;96713126;4649695
Jacobs;H55;2;30;121607287;123644129;2036842
Jacobs;H55;2;68;139131096;142593638;3462542
Jacobs;H55;2;37;156985451;159389044;2403593
Jacobs;H55;2;134;165399749;173034908;7635159
Jacobs;H55;2;25;237563114;238991301;1428187
Jacobs;H55;2;19;242462366;243302892;840526
Jacobs;H55;10;40;11308102;13767913;2459811
Jacobs;H55;10;39;14184398;16407508;2223110
Jacobs;H55;10;144;25827394;33648969;7821575
Jacobs;H55;10;15;33986642;34603291;616649
Jacobs;H55;10;35;36637311;39489315;2852004
Jacobs;H55;10;18;46618259;47487991;869732
Jacobs;H55;10;36;53303637;55726976;2423339
Jacobs;H55;10;29;57089480;59172145;2082665
Jacobs;H55;10;20;60841810;61638845;797035
Jacobs;H55;10;16;67307992;68271380;963388
Jacobs;H55;10;15;83912684;84741018;828334
Jacobs;H55;24;18;3439178;4766009;1326831
Jacobs;H55;24;68;12558998;17307132;4748134
Jacobs;H55;24;43;17996334;21581821;3585487
Jacobs;H55;24;19;33343694;34176391;832697
Navajo-Churro;H1;2;15;11400715;12330936;930221
Navajo-Churro;H1;2;19;15141339;16096373;955034
Navajo-Churro;H1;2;16;27784609;29338389;1553780
Navajo-Churro;H1;2;15;62482737;63387842;905105
Navajo-Churro;H1;2;36;71434200;73475221;2041021
Navajo-Churro;H1;2;75;77328509;80904183;3575674
Navajo-Churro;H1;2;70;84580673;88233994;3653321
Navajo-Churro;H1;2;19;144615833;145693768;1077935
Navajo-Churro;H1;2;18;148802744;149553962;751218
Navajo-Churro;H1;2;17;198339772;199110298;770526
Navajo-Churro;H1;2;44;202054228;203989901;1935673
Navajo-Churro;H1;10;17;32446306;33472505;1026199
Navajo-Churro;H1;10;39;49411181;51646916;2235735
Navajo-Churro;H1;10;45;80204165;82445757;2241592
Navajo-Churro;H1;24;17;15367865;16573702;1205837
Navajo-Churro;H1;24;18;26068027;27739247;1671220
Navajo-Churro;H9;2;85;9701540;14080986;4379446
Navajo-Churro;H9;2;17;25563222;26664802;1101580
Navajo-Churro;H9;2;1498;29912263;117934792;88022529
Navajo-Churro;H9;2;16;124657483;125343919;686436
Navajo-Churro;H9;2;19;131793590;132550706;757116
Navajo-Churro;H9;2;124;151200968;158665480;7464512
Navajo-Churro;H9;2;235;178647607;192989350;14341743
Navajo-Churro;H9;2;15;194755163;195890936;1135773
Navajo-Churro;H9;2;16;228660388;229397259;736871
Navajo-Churro;H9;2;111;236541718;243248420;6706702
Navajo-Churro;H9;10;15;26844939;27431037;586098
Navajo-Churro;H9;10;21;28852183;29882404;1030221
Navajo-Churro;H9;10;18;30272843;31152708;879865
Navajo-Churro;H9;10;21;36847123;38751668;1904545
Navajo-Churro;H9;24;40;29652597;32390507;2737910
Jacobs;H17;2;109;158066;6092514;5934448
Jacobs;H17;2;27;15477809;16975392;1497583
Jacobs;H17;2;16;28322438;29550469;1228031
Jacobs;H17;2;17;40875507;42000792;1125285
Jacobs;H17;2;92;70664942;76044554;5379612
Jacobs;H17;2;29;90752876;92132718;1379842
Jacobs;H17;2;47;107035638;109132360;2096722
Jacobs;H17;2;21;121796989;123494681;1697692
Jacobs;H17;2;468;126504764;152529090;26024326
Jacobs;H17;2;22;159437585;160748450;1310865
Jacobs;H17;2;136;164152670;171858694;7706024
Jacobs;H17;2;48;186366683;189186475;2819792
Jacobs;H17;2;15;192869029;193547722;678693
Jacobs;H17;2;16;198155571;198824819;669248
Jacobs;H17;2;37;204702992;206643029;1940037
Jacobs;H17;2;22;211512445;212806608;1294163
Jacobs;H17;2;31;230692645;232414241;1721596
Jacobs;H17;2;18;233988816;235032427;1043611
Jacobs;H17;2;58;240777646;244335478;3557832
Jacobs;H17;10;15;6334228;7492074;1157846
Jacobs;H17;10;51;21309973;24020844;2710871
Jacobs;H17;10;16;32773769;33648969;875200
Jacobs;H17;10;15;33986642;34603291;616649
Jacobs;H17;10;35;36637311;39489315;2852004
Jacobs;H17;10;18;46618259;47487991;869732
Jacobs;H17;10;23;50699349;51659456;960107
Jacobs;H17;10;25;52768972;54459673;1690701
Jacobs;H17;10;52;55689588;59172145;3482557
Jacobs;H17;10;20;67493967;68757883;1263916
Jacobs;H17;10;43;75314642;77411116;2096474
Jacobs;H17;10;18;79746530;80581510;834980
Jacobs;H17;10;70;81908310;85596458;3688148
Jacobs;H17;24;36;6265369;8314969;2049600
Jacobs;H17;24;31;17307132;19741398;2434266
Jacobs;H17;24;21;24776080;26068027;1291947
Jacobs;H17;24;25;27739247;29475441;1736194
Navajo-Churro;H2;2;17;22022061;22963619;941558
Navajo-Churro;H2;2;34;45015658;47450537;2434879
Navajo-Churro;H2;2;441;60095030;84640849;24545819
Navajo-Churro;H2;2;20;103466624;104524885;1058261
Navajo-Churro;H2;2;15;107866879;108527356;660477
Navajo-Churro;H2;2;19;110029030;111172962;1143932
Navajo-Churro;H2;2;20;113664053;115083516;1419463
Navajo-Churro;H2;2;99;220154626;225231192;5076566
Navajo-Churro;H2;2;80;230505362;235225978;4720616
Navajo-Churro;H2;2;38;235347013;237261566;1914553
Navajo-Churro;H2;2;16;242150818;243005095;854277
Navajo-Churro;H2;2;25;243907649;245206162;1298513
Navajo-Churro;H2;10;18;7430510;9003380;1572870
Navajo-Churro;H2;10;17;11027862;11920339;892477
Navajo-Churro;H2;10;16;22285343;23037038;751695
Navajo-Churro;H2;10;114;73060594;78849033;5788439
Navajo-Churro;H2;24;22;32984246;33961710;977464
Navajo-Churro;H2;24;28;36938439;38615161;1676722
Navajo-Churro;H10;2;32;14359717;15897797;1538080
Navajo-Churro;H10;2;15;20046763;20767838;721075
Navajo-Churro;H10;2;323;75745623;93932795;18187172
Navajo-Churro;H10;2;128;96439757;104016758;7577001
Navajo-Churro;H10;2;16;106470676;107171359;700683
Navajo-Churro;H10;2;31;108132547;109829764;1697217
Navajo-Churro;H10;2;17;121776284;123274303;1498019
Navajo-Churro;H10;2;17;146616690;147910340;1293650
Navajo-Churro;H10;2;18;169019218;170000512;981294
Navajo-Churro;H10;2;16;196296541;197177610;881069
Navajo-Churro;H10;2;18;199020889;199942549;921660
Navajo-Churro;H10;2;219;224864722;236768061;11903339
Navajo-Churro;H10;2;17;242676521;243449101;772580
Navajo-Churro;H10;10;30;7492074;9719458;2227384
Navajo-Churro;H10;10;19;10922307;12014265;1091958
Navajo-Churro;H10;10;21;13325738;14237125;911387
Navajo-Churro;H10;10;15;14485571;15306798;821227
Navajo-Churro;H10;10;18;32465060;33582901;1117841
Navajo-Churro;H10;10;16;47048429;47811109;762680
Navajo-Churro;H10;24;25;27613295;29314003;1700708
Navajo-Churro;H19;2;16;52731947;53563082;831135
Navajo-Churro;H19;2;38;53797807;55548084;1750277
Navajo-Churro;H19;2;114;59112309;64886088;5773779
Navajo-Churro;H19;2;15;72436861;73188664;751803
Navajo-Churro;H19;2;16;113014357;114558942;1544585
Navajo-Churro;H19;2;24;132208083;133229013;1020930
Navajo-Churro;H19;2;17;147821995;148711192;889197
Navajo-Churro;H19;2;21;156467512;157574569;1107057
Navajo-Churro;H19;2;15;173352916;174139621;786705
Navajo-Churro;H19;2;35;189117884;191042331;1924447
Navajo-Churro;H19;2;58;191834956;195087922;3252966
Navajo-Churro;H19;2;18;202054228;202899103;844875
Navajo-Churro;H19;2;16;208564435;209401403;836968
Navajo-Churro;H19;2;16;209703200;210557713;854513
Navajo-Churro;H19;2;17;212232636;213148055;915419
Navajo-Churro;H19;2;37;228897020;230926690;2029670
Navajo-Churro;H19;2;23;236027912;237488816;1460904
Navajo-Churro;H19;10;20;6254810;7701140;1446330
Navajo-Churro;H19;10;38;14137399;16338178;2200779
Navajo-Churro;H19;10;15;17428164;18263050;834886
Navajo-Churro;H19;10;15;44742514;45821356;1078842
Navajo-Churro;H19;24;64;16147749;21554660;5406911
Navajo-Churro;H3;2;23;16975392;18057959;1082567
Navajo-Churro;H3;2;15;19774453;20422624;648171
Navajo-Churro;H3;2;16;54086367;54744188;657821
Navajo-Churro;H3;2;22;73828642;75042274;1213632
Navajo-Churro;H3;2;15;85242819;86113413;870594
Navajo-Churro;H3;2;129;101171470;108470142;7298672
Navajo-Churro;H3;2;18;121734938;123274303;1539365
Navajo-Churro;H3;2;24;132208083;133229013;1020930
Navajo-Churro;H3;2;66;158192547;162219631;4027084
Navajo-Churro;H3;2;17;167736523;168665722;929199
Navajo-Churro;H3;2;19;204064678;205132747;1068069
Navajo-Churro;H3;10;34;31251390;33250039;1998649
Navajo-Churro;H3;10;28;62212986;64870917;2657931
Navajo-Churro;H3;10;20;74893559;75816964;923405
Navajo-Churro;H3;24;22;10208845;12181694;1972849
Navajo-Churro;H3;24;15;16310285;17460873;1150588
Navajo-Churro;H3;24;17;25638494;27091483;1452989
Navajo-Churro;H11;2;66;9157918;12558695;3400777
Navajo-Churro;H11;2;16;12636461;13571895;935434
Navajo-Churro;H11;2;15;36140443;37164388;1023945
Navajo-Churro;H11;2;24;40931803;42668778;1736975
Navajo-Churro;H11;2;42;85508894;87744101;2235207
Navajo-Churro;H11;2;20;107866879;108775514;908635
Navajo-Churro;H11;2;16;184760567;185974821;1214254
Navajo-Churro;H11;2;35;189117884;191042331;1924447
Navajo-Churro;H11;10;16;23865906;24561101;695195
Navajo-Churro;H11;10;17;29612155;30321628;709473
Navajo-Churro;H11;10;25;36653024;38751668;2098644
Navajo-Churro;H11;10;18;40105937;40771431;665494
Navajo-Churro;H11;10;19;43417893;44545554;1127661
Navajo-Churro;H11;10;22;49411181;50876668;1465487
Navajo-Churro;H11;10;24;67307992;68743197;1435205
Navajo-Churro;H11;24;26;9352754;11828268;2475514
Navajo-Churro;H11;24;30;21176747;23689555;2512808
Navajo-Churro;H11;24;22;33159082;34113252;954170
Navajo-Churro;H11;24;17;34345815;36036418;1690603
Navajo-Churro;H11;24;15;36962278;37716648;754370
Jacobs;H20;2;16;5798140;6740866;942726
Jacobs;H20;2;83;10376684;14837808;4461124
Jacobs;H20;2;32;38545616;40350901;1805285
Jacobs;H20;2;16;52327990;53043790;715800
Jacobs;H20;2;36;53304271;54936988;1632717
Jacobs;H20;2;79;57911484;61982604;4071120
Jacobs;H20;2;129;67488344;75042274;7553930
Jacobs;H20;2;106;75745623;80967126;5221503
Jacobs;H20;2;51;83531972;86582074;3050102
Jacobs;H20;2;22;91063757;92132718;1068961
Jacobs;H20;2;379;93102704;117158936;24056232
Jacobs;H20;2;23;122001925;123573014;1571089
Jacobs;H20;2;15;127997234;128625705;628471
Jacobs;H20;2;36;133272817;135391568;2118751
Jacobs;H20;2;25;136654969;138081646;1426677
Jacobs;H20;2;26;147210213;148953266;1743053
Jacobs;H20;2;16;158818859;159916624;1097765
Jacobs;H20;2;16;165486783;166276060;789277
Jacobs;H20;2;24;169929278;171362036;1432758
Jacobs;H20;2;116;179965972;187259707;7293735
Jacobs;H20;2;197;193151043;204071553;10920510
Jacobs;H20;2;51;215994089;220852308;4858219
Jacobs;H20;2;35;231069887;232977026;1907139
Jacobs;H20;10;27;21584008;22997802;1413794
Jacobs;H20;10;144;24977576;32637918;7660342
Jacobs;H20;10;29;36883392;39489315;2605923
Jacobs;H20;10;17;49446895;50699349;1252454
Jacobs;H20;10;21;52101841;53147209;1045368
Jacobs;H20;10;52;67238073;70162514;2924441
Jacobs;H20;10;52;71470411;74592356;3121945
Jacobs;H20;10;52;74752408;77411116;2658708
Jacobs;H20;24;15;16077497;17253902;1176405
Jacobs;H20;24;71;17996334;24060526;6064192
Jacobs;H20;24;18;24314975;25523363;1208388
Jacobs;H20;24;18;29314003;30456600;1142597
Jacobs;H20;24;28;33397677;35216176;1818499
Navajo-Churro;H4;2;38;14359717;16264144;1904427
Navajo-Churro;H4;2;33;70548455;72500691;1952236
Navajo-Churro;H4;2;17;72891678;73839087;947409
Navajo-Churro;H4;2;19;88339215;89567061;1227846
Navajo-Churro;H4;2;15;110284541;111172962;888421
Navajo-Churro;H4;2;24;121590788;123362485;1771697
Navajo-Churro;H4;2;16;124825010;125442142;617132
Navajo-Churro;H4;2;15;127390949;128292892;901943
Navajo-Churro;H4;2;17;146616690;147910340;1293650
Navajo-Churro;H4;2;19;178741258;180183585;1442327
Navajo-Churro;H4;2;20;194755163;196283661;1528498
Navajo-Churro;H4;10;30;7492074;9719458;2227384
Navajo-Churro;H4;10;19;10922307;12014265;1091958
Navajo-Churro;H4;10;21;13325738;14237125;911387
Navajo-Churro;H4;10;15;14485571;15306798;821227
Navajo-Churro;H4;10;16;46306279;47048429;742150
Navajo-Churro;H4;10;17;68818754;69603264;784510
Navajo-Churro;H4;10;15;83277025;83912684;635659
Navajo-Churro;H4;24;25;27613295;29314003;1700708
Navajo-Churro;H12;2;16;16042496;16805125;762629
Navajo-Churro;H12;2;80;25811615;31018254;5206639
Navajo-Churro;H12;2;20;53837176;54681929;844753
Navajo-Churro;H12;2;309;67168555;84705740;17537185
Navajo-Churro;H12;2;15;85242819;86113413;870594
Navajo-Churro;H12;2;513;95731895;127173649;31441754
Navajo-Churro;H12;2;15;173352916;174139621;786705
Navajo-Churro;H12;2;35;189117884;191042331;1924447
Navajo-Churro;H12;2;58;191834956;195087922;3252966
Navajo-Churro;H12;2;18;202054228;202899103;844875
Navajo-Churro;H12;2;17;218309332;219831281;1521949
Navajo-Churro;H12;2;16;226880698;227734587;853889
Navajo-Churro;H12;2;17;246615094;247548978;933884
Navajo-Churro;H12;10;17;32818994;33808019;989025
Navajo-Churro;H12;10;17;74728587;75599218;870631
Jacobs;H21;2;23;14914968;16096373;1181405
Jacobs;H21;2;17;18584559;19163821;579262
Jacobs;H21;2;15;20816743;21614658;797915
Jacobs;H21;2;19;39327845;40350901;1023056
Jacobs;H21;2;35;42199949;44430836;2230887
Jacobs;H21;2;720;48816011;87916949;39100938
Jacobs;H21;2;29;91143985;92891269;1747284
Jacobs;H21;2;20;109420304;110765081;1344777
Jacobs;H21;2;29;110875234;114279784;3404550
Jacobs;H21;2;23;116534114;117702396;1168282
Jacobs;H21;2;21;121796989;123494681;1697692
Jacobs;H21;2;40;142709866;145090781;2380915
Jacobs;H21;2;24;155026089;156230655;1204566
Jacobs;H21;2;20;158558328;159916624;1358296
Jacobs;H21;2;16;177951142;178741258;790116
Jacobs;H21;2;15;182286302;182923305;637003
Jacobs;H21;2;61;214005350;219774612;5769262
Jacobs;H21;2;20;220083076;221153389;1070313
Jacobs;H21;2;50;226617529;229189424;2571895
Jacobs;H21;2;29;230789586;232414241;1624655
Jacobs;H21;2;50;233988816;236285593;2296777
Jacobs;H21;10;23;22713402;23902878;1189476
Jacobs;H21;10;70;29882404;33648969;3766565
Jacobs;H21;10;35;33885776;35528316;1642540
Jacobs;H21;10;29;36883392;39489315;2605923
Jacobs;H21;10;19;40105937;40971187;865250
Jacobs;H21;10;18;46618259;47487991;869732
Jacobs;H21;10;18;50632207;51490237;858030
Jacobs;H21;10;86;55689588;60964115;5274527
Jacobs;H21;10;58;66779341;70162514;3383173
Jacobs;H21;10;181;71470411;81307769;9837358
Jacobs;H21;24;24;7615311;8842899;1227588
Jacobs;H21;24;352;12065734;38184103;26118369
Jacobs;H13;2;190;39411236;51291515;11880279
Jacobs;H13;2;16;64771512;65574894;803382
Jacobs;H13;2;460;70664942;96963289;26298347
Jacobs;H13;2;447;100603953;127495017;26891064
Jacobs;H13;2;17;132841528;133563038;721510
Jacobs;H13;2;34;178388511;180818063;2429552
Jacobs;H13;2;15;206346660;207322502;975842
Jacobs;H13;2;50;211512445;215251657;3739212
Jacobs;H13;2;52;215844761;220852308;5007547
Jacobs;H13;2;15;225231192;226003694;772502
Jacobs;H13;2;31;229423565;231288643;1865078
Jacobs;H13;2;36;232260867;234602983;2342116
Jacobs;H13;2;19;235046820;235723972;677152
Jacobs;H13;2;16;238831242;239564082;732840
Jacobs;H13;10;58;14237125;17481523;3244398
Jacobs;H13;10;265;29415140;45845544;16430404
Jacobs;H13;10;52;46536830;48972916;2436086
Jacobs;H13;10;22;52844259;54375509;1531250
Jacobs;H13;24;95;16077497;24060526;7983029
Jacobs;H22;2;73;1482554;4835268;3352714
Jacobs;H22;2;48;11697656;14359717;2662061
Jacobs;H22;2;19;14837808;15741288;903480
Jacobs;H22;2;18;21334859;22316785;981926
Jacobs;H22;2;17;23963448;24861755;898307
Jacobs;H22;2;114;25709378;32893038;7183660
Jacobs;H22;2;36;68216266;70040931;1824665
Jacobs;H22;2;15;73109758;73839087;729329
Jacobs;H22;2;36;79183271;80967126;1783855
Jacobs;H22;2;70;92213984;96254860;4040876
Jacobs;H22;2;80;101183181;106302944;5119763
Jacobs;H22;2;271;116953479;131682707;14729228
Jacobs;H22;2;32;149470913;151200968;1730055
Jacobs;H22;2;15;157646578;158558328;911750
Jacobs;H22;2;17;172616581;173532404;915823
Jacobs;H22;2;27;176369323;178150411;1781088
Jacobs;H22;2;99;178388511;184673171;6284660
Jacobs;H22;2;69;196397256;200044698;3647442
Jacobs;H22;2;72;211512445;217457102;5944657
Jacobs;H22;2;54;222606287;225193189;2586902
Jacobs;H22;2;15;230006689;230823473;816784
Jacobs;H22;2;35;231069887;232977026;1907139
Jacobs;H22;10;15;2905602;3761734;856132
Jacobs;H22;10;16;30072709;30849548;776839
Jacobs;H22;10;32;36770781;39489315;2718534
Jacobs;H22;10;30;42731359;45133795;2402436
Jacobs;H22;24;77;12558998;17996334;5437336
Jacobs;H22;24;77;36036418;42027686;5991268
Navajo-Churro;H6;2;15;43932768;44728489;795721
Navajo-Churro;H6;2;15;60869601;61621077;751476
Navajo-Churro;H6;2;51;64504436;67387676;2883240
Navajo-Churro;H6;2;21;80125390;80942245;816855
Navajo-Churro;H6;2;18;105769436;106749240;979804
Navajo-Churro;H6;2;61;117795421;121299744;3504323
Navajo-Churro;H6;2;27;164152670;165447554;1294884
Navajo-Churro;H6;2;15;181165187;182097199;932012
Navajo-Churro;H6;2;21;241839716;243050370;1210654
Navajo-Churro;H6;10;21;23604001;24561101;957100
Navajo-Churro;H6;10;76;25768345;29882404;4114059
Navajo-Churro;H6;10;23;38649780;40105937;1456157
Navajo-Churro;H6;24;15;24846522;25809786;963264
Navajo-Churro;H6;24;15;26493858;27739247;1245389
Navajo-Churro;H14;2;199;3563752;14359717;10795965
Navajo-Churro;H14;2;17;55946911;56751008;804097
Navajo-Churro;H14;2;15;79285145;80262318;977173
Navajo-Churro;H14;2;27;107227866;108309773;1081907
Navajo-Churro;H14;2;25;129421996;130831021;1409025
Navajo-Churro;H14;2;35;136336816;138159566;1822750
Navajo-Churro;H14;2;15;145693768;146381974;688206
Navajo-Churro;H14;2;22;165941483;167358125;1416642
Navajo-Churro;H14;2;19;175418941;176765339;1346398
Navajo-Churro;H14;2;18;190937309;191673164;735855
Navajo-Churro;H14;2;26;193596846;195428641;1831795
Navajo-Churro;H14;10;22;29502667;30559444;1056777
Navajo-Churro;H14;10;18;32465060;33582901;1117841
Navajo-Churro;H14;10;24;35744011;37055676;1311665
Navajo-Churro;H14;10;26;43417893;44929212;1511319
Navajo-Churro;H14;10;154;53666062;63808989;10142927
Navajo-Churro;H14;24;28;21176747;23509895;2333148
Jacobs;H7;2;15;13571895;14159758;587863
Jacobs;H7;2;180;16416165;25765503;9349338
Jacobs;H7;2;68;30463448;34096217;3632769
Jacobs;H7;2;36;39327845;41597285;2269440
Jacobs;H7;2;16;52327990;53043790;715800
Jacobs;H7;2;36;53304271;54936988;1632717
Jacobs;H7;2;79;57911484;61982604;4071120
Jacobs;H7;2;129;67488344;75042274;7553930
Jacobs;H7;2;139;75745623;82856320;7110697
Jacobs;H7;2;42;84054194;86582074;2527880
Jacobs;H7;2;49;91063757;93856462;2792705
Jacobs;H7;2;176;117369115;127043193;9674078
Jacobs;H7;2;124;133272817;140442104;7169287
Jacobs;H7;2;67;140937497;144615833;3678336
Jacobs;H7;2;18;163695948;164516447;820499
Jacobs;H7;2;15;170218116;171206036;987920
Jacobs;H7;2;89;199432096;203989901;4557805
Jacobs;H7;2;41;205305554;207694488;2388934
Jacobs;H7;2;27;215994089;219015064;3020975
Jacobs;H7;10;20;2277631;3333520;1055889
Jacobs;H7;10;27;21584008;22997802;1413794
Jacobs;H7;10;110;24977576;30743409;5765833
Jacobs;H7;10;18;35566480;36526839;960359
Jacobs;H7;10;36;36847123;39942731;3095608
Jacobs;H7;10;18;49411181;50699349;1288168
Jacobs;H7;10;21;52101841;53147209;1045368
Jacobs;H7;10;52;71470411;74592356;3121945
Jacobs;H7;10;52;74752408;77411116;2658708
Jacobs;H7;10;22;84494277;85596458;1102181
Jacobs;H7;24;31;11076801;13647199;2570398
Jacobs;H7;24;67;16077497;21581821;5504324
Jacobs;H7;24;15;34225118;35585230;1360112
Jacobs;H7;24;17;38840214;39735778;895564
Jacobs;H7;24;19;40193947;42027686;1833739
Navajo-Churro;H15;2;189;14272947;24005033;9732086
Navajo-Churro;H15;2;21;53797807;54681929;884122
Navajo-Churro;H15;2;172;56413369;64886088;8472719
Navajo-Churro;H15;2;15;72436861;73188664;751803
Navajo-Churro;H15;2;864;92132718;142902297;50769579
Navajo-Churro;H15;2;21;144500078;145628424;1128346
Navajo-Churro;H15;2;15;173352916;174139621;786705
Navajo-Churro;H15;2;20;182607165;183721180;1114015
Navajo-Churro;H15;10;16;20805065;21682188;877123
Navajo-Churro;H15;10;17;32888699;33843863;955164
Navajo-Churro;H15;10;35;42210604;44929212;2718608
Navajo-Churro;H15;10;273;52707146;70162514;17455368
Navajo-Churro;H15;10;130;71470411;78682047;7211636
Navajo-Churro;H15;10;38;82867736;84741018;1873282
Navajo-Churro;H15;24;19;25614223;27159621;1545398
Navajo-Churro;H15;24;16;31774063;32552648;778585
Navajo-Churro;H24;2;22;46045582;47853771;1808189
Navajo-Churro;H24;2;19;54135888;54936988;801100
Navajo-Churro;H24;2;20;72769457;73839087;1069630
Navajo-Churro;H24;2;21;84705740;85982773;1277033
Navajo-Churro;H24;2;21;86798921;87816239;1017318
Navajo-Churro;H24;2;17;142123229;143177828;1054599
Navajo-Churro;H24;2;21;144500078;145628424;1128346
Navajo-Churro;H24;2;19;175418941;176765339;1346398
Navajo-Churro;H24;2;15;189470005;190239376;769371
Navajo-Churro;H24;2;20;242462366;243365308;902942
Navajo-Churro;H24;10;20;46573078;47513384;940306
Navajo-Churro;H24;10;16;84100127;84946996;846869
Navajo-Churro;H24;24;21;20406106;21910840;1504734
Navajo-Churro;H24;24;22;34113252;36076909;1963657
Navajo-Churro;H8;2;15;1426911;2157185;730274
Navajo-Churro;H8;2;17;41567516;42668778;1101262
Navajo-Churro;H8;2;19;54135888;54936988;801100
Navajo-Churro;H8;2;20;71434200;72607674;1173474
Navajo-Churro;H8;2;17;73046724;73926990;880266
Navajo-Churro;H8;2;16;80343267;80942245;598978
Navajo-Churro;H8;2;17;88681374;90205014;1523640
Navajo-Churro;H8;2;19;103640034;104876321;1236287
Navajo-Churro;H8;2;27;108235636;109633672;1398036
Navajo-Churro;H8;2;26;129421996;130880304;1458308
Navajo-Churro;H8;2;25;148479250;149553962;1074712
Navajo-Churro;H8;2;18;212749665;213674776;925111
Navajo-Churro;H8;2;18;218418759;219933911;1515152
Navajo-Churro;H8;2;19;227921207;228848890;927683
Navajo-Churro;H8;10;16;8535156;9353873;818717
Navajo-Churro;H8;10;28;10922307;12600289;1677982
Navajo-Churro;H8;10;21;23604001;24561101;957100
Navajo-Churro;H8;10;76;25768345;29882404;4114059
Navajo-Churro;H8;10;23;38649780;40105937;1456157
Navajo-Churro;H8;24;59;5384735;8579698;3194963
Jacobs;H16;2;20;10206141;10967299;761158
Jacobs;H16;2;23;14914968;16096373;1181405
Jacobs;H16;2;17;18584559;19163821;579262
Jacobs;H16;2;15;20816743;21614658;797915
Jacobs;H16;2;36;39327845;41597285;2269440
Jacobs;H16;2;16;52327990;53043790;715800
Jacobs;H16;2;36;53304271;54936988;1632717
Jacobs;H16;2;79;57911484;61982604;4071120
Jacobs;H16;2;129;67488344;75042274;7553930
Jacobs;H16;2;139;75745623;82856320;7110697
Jacobs;H16;2;42;84054194;86582074;2527880
Jacobs;H16;2;49;91063757;93856462;2792705
Jacobs;H16;2;101;117369115;123446725;6077610
Jacobs;H16;2;15;124533614;125164918;631304
Jacobs;H16;2;18;133272817;134301618;1028801
Jacobs;H16;2;20;140158515;141180010;1021495
Jacobs;H16;2;16;154256628;155107453;850825
Jacobs;H16;2;18;163695948;164516447;820499
Jacobs;H16;2;15;170218116;171206036;987920
Jacobs;H16;2;15;195245620;196397256;1151636
Jacobs;H16;2;50;211512445;215251657;3739212
Jacobs;H16;2;52;215844761;220852308;5007547
Jacobs;H16;2;22;226617529;227781732;1164203
Jacobs;H16;2;24;231069887;232414241;1344354
Jacobs;H16;2;31;238831242;240477448;1646206
Jacobs;H16;2;16;247955981;248799264;843283
Jacobs;H16;10;20;2277631;3333520;1055889
Jacobs;H16;10;21;21149696;22285343;1135647
Jacobs;H16;10;20;22865153;23902878;1037725
Jacobs;H16;10;201;32773769;45845544;13071775
Jacobs;H16;10;23;50632207;51646916;1014709
Jacobs;H16;10;50;55944722;59172145;3227423
Jacobs;H16;10;107;71470411;77411116;5940705
Jacobs;H16;10;40;77753126;79746530;1993404
Jacobs;H16;10;22;84494277;85596458;1102181
Jacobs;H16;24;17;5621749;6468168;846419
Jacobs;H16;24;20;9010958;10471141;1460183
Jacobs;H16;24;71;16147749;22222030;6074281
Jacobs;H16;24;15;34225118;35585230;1360112
Navajo-Churro;H25;2;29;9589549;10835399;1245850
Navajo-Churro;H25;2;16;11400715;12418291;1017576
Navajo-Churro;H25;2;18;15035660;15897797;862137
Navajo-Churro;H25;2;35;20921329;22784701;1863372
Navajo-Churro;H25;2;45;34089866;36286992;2197126
Navajo-Churro;H25;2;39;52050037;54047306;1997269
Navajo-Churro;H25;2;21;80125390;80942245;816855
Navajo-Churro;H25;2;19;103640034;104876321;1236287
Navajo-Churro;H25;2;18;110083416;111172962;1089546
Navajo-Churro;H25;2;22;168799360;170000512;1201152
Navajo-Churro;H25;2;22;178741258;180371082;1629824
Navajo-Churro;H25;2;18;198596572;199312723;716151
Navajo-Churro;H25;2;22;209637524;210708881;1071357
Navajo-Churro;H25;2;16;228531586;229349932;818346
Navajo-Churro;H25;2;23;230439460;231769134;1329674
Navajo-Churro;H25;2;15;239390747;240281174;890427
Navajo-Churro;H25;2;20;241950529;243050370;1099841
Navajo-Churro;H25;10;16;9199074;9970267;771193
Navajo-Churro;H25;10;86;25768345;30321628;4553283
Navajo-Churro;H25;10;17;32818994;33808019;989025
Navajo-Churro;H25;10;29;42113800;44519802;2406002
Navajo-Churro;H25;10;16;74681400;75531431;850031
Jacobs;H64;2;45;354035;2991783;2637748
Jacobs;H64;2;22;7727437;9369266;1641829
Jacobs;H64;2;30;11697656;13473852;1776196
Jacobs;H64;2;23;25811615;27218367;1406752
Jacobs;H64;2;32;38506443;40269973;1763530
Jacobs;H64;2;15;52409379;53043790;634411
Jacobs;H64;2;19;53986551;54687816;701265
Jacobs;H64;2;92;70664942;76044554;5379612
Jacobs;H64;2;247;76627899;90557732;13929833
Jacobs;H64;2;16;94894157;95731895;837738
Jacobs;H64;2;24;96254860;97741243;1486383
Jacobs;H64;2;86;100147522;105189556;5042034
Jacobs;H64;2;17;125261082;125922359;661277
Jacobs;H64;2;35;130636386;132323750;1687364
Jacobs;H64;2;23;140044111;141180010;1135899
Jacobs;H64;2;42;142250151;144615833;2365682
Jacobs;H64;2;24;157697393;159389044;1691651
Jacobs;H64;2;117;165399749;172151603;6751854
Jacobs;H64;2;131;198217868;204997139;6779271
Jacobs;H64;2;55;211512445;215443702;3931257
Jacobs;H64;2;51;215844761;220818676;4973915
Jacobs;H64;2;38;241649475;244066362;2416887
Jacobs;H64;10;67;4518697;9416750;4898053
Jacobs;H64;10;17;20329835;21309973;980138
Jacobs;H64;10;28;22955949;24422906;1466957
Jacobs;H64;10;128;25827394;32637918;6810524
Jacobs;H64;10;29;36883392;39489315;2605923
Jacobs;H64;10;16;67307992;68271380;963388
Jacobs;H64;10;21;79416539;80519356;1102817
Jacobs;H64;10;28;83775117;85263429;1488312
Jacobs;H64;24;77;12558998;17996334;5437336
Jacobs;H64;24;28;33397677;35216176;1818499
Jacobs;H62;2;40;4166902;6003251;1836349
Jacobs;H62;2;27;8180894;9735180;1554286
Jacobs;H62;2;135;15568475;22664271;7095796
Jacobs;H62;2;85;66730561;71739429;5008868
Jacobs;H62;2;15;73109758;73839087;729329
Jacobs;H62;2;51;86104148;88553200;2449052
Jacobs;H62;2;26;121231306;122918820;1687514
Jacobs;H62;2;55;131474019;134094336;2620317
Jacobs;H62;2;17;134667278;135451498;784220
Jacobs;H62;2;140;179122335;188204145;9081810
Jacobs;H62;2;15;208020229;208676009;655780
Jacobs;H62;2;17;215812352;218058406;2246054
Jacobs;H62;10;68;14894636;18737350;3842714
Jacobs;H62;10;22;19096234;20329835;1233601
Jacobs;H62;10;19;22713402;23673666;960264
Jacobs;H62;10;391;26003809;48972916;22969107
Jacobs;H62;10;44;75314642;77507372;2192730
Jacobs;H62;24;73;12181694;17307132;5125438
Jacobs;H62;24;18;24925070;26068027;1142957
Jacobs;H62;24;25;27739247;29475441;1736194
Navajo-Churro;H63;2;24;45150277;46557607;1407330
Navajo-Churro;H63;2;17;55974621;56804497;829876
Navajo-Churro;H63;2;19;103640034;104876321;1236287
Navajo-Churro;H63;2;18;110083416;111172962;1089546
Navajo-Churro;H63;2;20;189139931;190302285;1162354
Navajo-Churro;H63;10;17;11027862;11920339;892477
Navajo-Churro;H63;10;15;15018558;16034194;1015636
Navajo-Churro;H63;10;18;33919791;34711242;791451
Navajo-Churro;H63;10;16;37243595;39072962;1829367
Navajo-Churro;H63;10;15;58847824;59568964;721140
Navajo-Churro;H63;10;17;76379406;77142109;762703
Navajo-Churro;H63;24;22;12129478;13767641;1638163
Navajo-Churro;H63;24;19;25961188;27680635;1719447
Jacobs;H118;2;16;10266961;10887825;620864
Jacobs;H118;2;25;20016014;21129571;1113557
Jacobs;H118;2;17;32268777;33270908;1002131
Jacobs;H118;2;18;35582012;36544130;962118
Jacobs;H118;2;102;51529698;56751008;5221310
Jacobs;H118;2;19;73828642;74891548;1062906
Jacobs;H118;2;45;79017511;81273844;2256333
Jacobs;H118;2;58;83115753;86582074;3466321
Jacobs;H118;2;16;101134453;101709271;574818
Jacobs;H118;2;233;102804384;118180362;15375978
Jacobs;H118;2;19;119165943;120073154;907211
Jacobs;H118;2;15;122301320;123494681;1193361
Jacobs;H118;2;39;133272817;135474064;2201247
Jacobs;H118;2;50;140044111;142593638;2549527
Jacobs;H118;2;24;178010644;179673400;1662756
Jacobs;H118;2;60;187856073;191307142;3451069
Jacobs;H118;2;31;198875303;200749064;1873761
Jacobs;H118;2;31;203877619;205572258;1694639
Jacobs;H118;2;22;211512445;212806608;1294163
Jacobs;H118;2;88;215147086;221624187;6477101
Jacobs;H118;2;87;221940916;226477839;4536923
Jacobs;H118;2;78;233461442;237613535;4152093
Jacobs;H118;2;15;244129054;244947713;818659
Jacobs;H118;10;57;4518697;8904686;4385989
Jacobs;H118;10;55;20540068;23604001;3063933
Jacobs;H118;10;406;29238591;52581314;23342723
Jacobs;H118;10;25;52768972;54459673;1690701
Jacobs;H118;10;29;68694545;70162514;1467969
Jacobs;H118;10;17;76428043;77210348;782305
Jacobs;H118;10;38;80865534;82687218;1821684
Jacobs;H118;24;16;15865169;17159602;1294433
Jacobs;H118;24;16;26493858;27928201;1434343
Jacobs;H119;2;109;158066;6092514;5934448
Jacobs;H119;2;31;13307050;14837808;1530758
Jacobs;H119;2;78;15322091;19404154;4082063
Jacobs;H119;2;86;29409606;34303557;4893951
Jacobs;H119;2;86;40790032;46146229;5356197
Jacobs;H119;2;15;49484087;50080258;596171
Jacobs;H119;2;97;58791324;63837976;5046652
Jacobs;H119;2;176;65876876;76464705;10587829
Jacobs;H119;2;43;80262318;82192970;1930652
Jacobs;H119;2;17;103407822;104281644;873822
Jacobs;H119;2;23;122001925;123573014;1571089
Jacobs;H119;2;17;134194138;135084325;890187
Jacobs;H119;2;31;162689295;164308657;1619362
Jacobs;H119;2;15;198176953;198824819;647866
Jacobs;H119;2;16;215443702;216807667;1363965
Jacobs;H119;2;16;231543005;232414241;871236
Jacobs;H119;2;16;232591652;233623788;1032136
Jacobs;H119;2;31;241649475;243449101;1799626
Jacobs;H119;2;26;246116878;247245173;1128295
Jacobs;H119;10;19;10108612;11027862;919250
Jacobs;H119;10;41;14894636;17138817;2244181
Jacobs;H119;10;23;18296995;19689245;1392250
Jacobs;H119;10;145;23213276;30849548;7636272
Jacobs;H119;10;278;35566480;52419746;16853266
Jacobs;H119;10;26;55319894;56946876;1626982
Jacobs;H119;10;45;71470411;74308075;2837664
Jacobs;H119;10;21;77507372;78599973;1092601
Jacobs;H119;10;22;79312434;80519356;1206922
Jacobs;H119;10;31;82994149;84537988;1543839
Jacobs;H119;24;23;8170749;9268996;1098247
Jacobs;H119;24;21;15324479;16892562;1568083
Jacobs;H119;24;15;24776080;25710129;934049
Jacobs;H120;2;86;29409606;34303557;4893951
Jacobs;H120;2;86;40790032;46146229;5356197
Jacobs;H120;2;15;49484087;50080258;596171
Jacobs;H120;2;97;58791324;63837976;5046652
Jacobs;H120;2;256;65876876;80421373;14544497
Jacobs;H120;2;43;81758958;84580673;2821715
Jacobs;H120;2;17;94981400;96022899;1041499
Jacobs;H120;2;18;108309773;109132360;822587
Jacobs;H120;2;17;110606314;112190964;1584650
Jacobs;H120;2;25;114883685;116350674;1466989
Jacobs;H120;2;16;116635922;117464089;828167
Jacobs;H120;2;23;122001925;123573014;1571089
Jacobs;H120;2;22;128625705;129602869;977164
Jacobs;H120;2;39;131397735;133040292;1642557
Jacobs;H120;2;40;140827873;142963793;2135920
Jacobs;H120;2;31;162689295;164308657;1619362
Jacobs;H120;2;16;198155571;198824819;669248
Jacobs;H120;2;16;215443702;216807667;1363965
Jacobs;H120;2;16;231543005;232414241;871236
Jacobs;H120;2;16;232591652;233623788;1032136
Jacobs;H120;2;22;241649475;243005095;1355620
Jacobs;H120;2;21;246478010;247498052;1020042
Jacobs;H120;10;41;14894636;17138817;2244181
Jacobs;H120;10;17;18737350;19689245;951895
Jacobs;H120;10;145;23213276;30849548;7636272
Jacobs;H120;10;146;35566480;45845544;10279064
Jacobs;H120;10;26;55319894;56946876;1626982
Jacobs;H120;10;45;71470411;74308075;2837664
Jacobs;H120;10;21;77507372;78599973;1092601
Jacobs;H120;10;22;79312434;80519356;1206922
Jacobs;H120;10;15;84774726;85580441;805715
Jacobs;H121;2;22;4080987;5039528;958541
Jacobs;H121;2;22;6625835;7925142;1299307
Jacobs;H121;2;51;19038121;21756019;2717898
Jacobs;H121;2;42;29717625;31978915;2261290
Jacobs;H121;2;27;49602010;51384849;1782839
Jacobs;H121;2;29;66730561;68326509;1595948
Jacobs;H121;2;34;69626926;71739429;2112503
Jacobs;H121;2;15;73109758;73839087;729329
Jacobs;H121;2;36;79183271;80967126;1783855
Jacobs;H121;2;69;82290592;86582074;4291482
Jacobs;H121;2;41;88080464;90977972;2897508
Jacobs;H121;2;67;91063757;94768669;3704912
Jacobs;H121;2;47;107035638;109132360;2096722
Jacobs;H121;2;21;121796989;123494681;1697692
Jacobs;H121;2;17;129537914;130606432;1068518
Jacobs;H121;2;24;131596312;132550706;954394
Jacobs;H121;2;23;136632758;137832529;1199771
Jacobs;H121;2;24;148986290;150059057;1072767
Jacobs;H121;2;15;156555652;157252102;696450
Jacobs;H121;2;15;167511192;168264380;753188
Jacobs;H121;2;19;189470005;190441232;971227
Jacobs;H121;2;23;198495174;199546123;1050949
Jacobs;H121;2;32;200294436;202080321;1785885
Jacobs;H121;2;16;215443702;216807667;1363965
Jacobs;H121;2;123;223876023;230439460;6563437
Jacobs;H121;2;16;235184763;235723972;539209
Jacobs;H121;2;15;239564082;240409281;845199
Jacobs;H121;10;15;3499526;4405111;905585
Jacobs;H121;10;16;20329835;21273163;943328
Jacobs;H121;10;415;29202499;53098812;23896313
Jacobs;H121;10;20;68271380;69311273;1039893
Jacobs;H121;10;45;71470411;74308075;2837664
Jacobs;H121;10;42;74924462;77011574;2087112
Jacobs;H121;10;40;77210348;79248759;2038411
Jacobs;H121;24;23;8170749;9268996;1098247
Jacobs;H121;24;15;15324479;16147749;823270
Jacobs;H121;24;17;19946691;21392558;1445867
Jacobs;H121;24;72;23828331;29197813;5369482
Jacobs;H122;2;80;945715;4835268;3889553
Jacobs;H122;2;24;14359717;15388156;1028439
Jacobs;H122;2;51;26520393;30051860;3531467
Jacobs;H122;2;66;54135888;57495366;3359478
Jacobs;H122;2;105;70548455;76783372;6234917
Jacobs;H122;2;42;84054194;86582074;2527880
Jacobs;H122;2;18;101030254;101709271;679017
Jacobs;H122;2;15;110083416;110941391;857975
Jacobs;H122;2;21;121796989;123494681;1697692
Jacobs;H122;2;25;127306102;128843993;1537891
Jacobs;H122;2;23;130368989;131682707;1313718
Jacobs;H122;2;26;132749103;134094336;1345233
Jacobs;H122;2;16;134667278;135446006;778728
Jacobs;H122;2;16;148986290;149553962;567672
Jacobs;H122;2;16;190574847;191319781;744934
Jacobs;H122;2;18;215443702;217457102;2013400
Jacobs;H122;2;44;217719922;220955491;3235569
Jacobs;H122;2;47;221633575;224027318;2393743
Jacobs;H122;2;16;231543005;232414241;871236
Jacobs;H122;2;16;232591652;233623788;1032136
Jacobs;H122;2;16;239510065;240409281;899216
Jacobs;H122;10;15;3499526;4405111;905585
Jacobs;H122;10;16;20329835;21273163;943328
Jacobs;H122;10;402;29202499;52419746;23217247
Jacobs;H122;10;30;52768972;54824597;2055625
Jacobs;H122;10;118;55075006;62065368;6990362
Jacobs;H122;10;82;63706057;68597311;4891254
Jacobs;H122;10;206;71470411;82590071;11119660
Jacobs;H122;24;51;5593329;8379806;2786477
Jacobs;H122;24;15;15324479;16147749;823270
Jacobs;H122;24;17;19946691;21392558;1445867
Jacobs;H122;24;71;24040495;29197813;5157318
Jacobs;H123;2;16;37164388;38506443;1342055
Jacobs;H123;2;16;52327990;53043790;715800
Jacobs;H123;2;19;53986551;54687816;701265
Jacobs;H123;2;17;56446750;57307599;860849
Jacobs;H123;2;20;108235636;109132360;896724
Jacobs;H123;2;24;113897647;115665643;1767996
Jacobs;H123;2;23;122001925;123573014;1571089
Jacobs;H123;2;15;135636519;136565040;928521
Jacobs;H123;2;71;150948753;155337073;4388320
Jacobs;H123;2;23;168719169;170000512;1281343
Jacobs;H123;2;16;190574847;191319781;744934
Jacobs;H123;2;113;208020229;215098553;7078324
Jacobs;H123;2;18;215443702;217457102;2013400
Jacobs;H123;2;15;236541718;237613535;1071817
Jacobs;H123;2;15;246121938;246701174;579236
Jacobs;H123;10;27;16196817;17481523;1284706
Jacobs;H123;10;18;31493771;32637918;1144147
Jacobs;H123;10;29;36883392;39489315;2605923
Jacobs;H123;10;18;40149974;40971187;821213
Jacobs;H123;10;60;47228374;50071084;2842710
Jacobs;H123;10;65;57335879;61237051;3901172
Jacobs;H123;24;44;11076801;14492312;3415511
Jacobs;H124;2;17;3961544;4670884;709340
Jacobs;H124;2;60;16416165;19404154;2987989
Jacobs;H124;2;27;25939009;27546603;1607594
Jacobs;H124;2;183;49602010;59306755;9704745
Jacobs;H124;2;29;66730561;68326509;1595948
Jacobs;H124;2;18;70802060;71844617;1042557
Jacobs;H124;2;15;73109758;73839087;729329
Jacobs;H124;2;36;80857803;82706925;1849122
Jacobs;H124;2;24;92213984;93601809;1387825
Jacobs;H124;2;27;94894157;96566325;1672168
Jacobs;H124;2;25;101985195;103407822;1422627
Jacobs;H124;2;191;116350674;126926047;10575373
Jacobs;H124;2;60;129421996;132550706;3128710
Jacobs;H124;2;34;142709866;144672338;1962472
Jacobs;H124;2;91;157252102;162572509;5320407
Jacobs;H124;2;15;176695897;177580706;884809
Jacobs;H124;2;17;199076879;199942549;865670
Jacobs;H124;2;18;205244432;206276753;1032321
Jacobs;H124;2;132;208232368;217457102;9224734
Jacobs;H124;2;20;218058406;219694019;1635613
Jacobs;H124;2;44;238041313;240409281;2367968
Jacobs;H124;10;23;10561517;11853718;1292201
Jacobs;H124;10;27;16196817;17481523;1284706
Jacobs;H124;10;32;21682188;23289566;1607378
Jacobs;H124;10;68;25827394;29502667;3675273
Jacobs;H124;10;34;41802553;44519802;2717249
Jacobs;H124;10;38;48323497;50071084;1747587
Jacobs;H124;10;35;50920778;52419746;1498968
Jacobs;H124;10;27;52670855;54459673;1788818
Jacobs;H124;10;17;67493967;68597311;1103344
Jacobs;H124;24;17;23497703;24690825;1193122
Jacobs;H125;2;28;44660277;46163449;1503172
Jacobs;H125;2;17;73046724;73926990;880266
Jacobs;H125;2;55;84054194;87222916;3168722
Jacobs;H125;2;18;101030254;101709271;679017
Jacobs;H125;2;47;107035638;109132360;2096722
Jacobs;H125;2;21;121796989;123494681;1697692
Jacobs;H125;2;26;149768329;151345671;1577342
Jacobs;H125;2;37;162689295;164594319;1905024
Jacobs;H125;2;17;171889296;172616581;727285
Jacobs;H125;2;15;175346551;176135485;788934
Jacobs;H125;2;28;189117884;190697862;1579978
Jacobs;H125;2;36;200125811;202249334;2123523
Jacobs;H125;2;23;215994089;218592494;2598405
Jacobs;H125;2;41;219357404;221711968;2354564
Jacobs;H125;2;123;223876023;230439460;6563437
Jacobs;H125;10;779;14894636;60406613;45511977
Jacobs;H125;10;45;71470411;74308075;2837664
Jacobs;H125;10;46;75922918;78378416;2455498
Jacobs;H125;24;74;26493858;31947993;5454135
Jacobs;H126;2;92;46491700;52266474;5774774
Jacobs;H126;2;23;53528684;54596587;1067903
Jacobs;H126;2;19;70664942;71739429;1074487
Jacobs;H126;2;15;73109758;73839087;729329
Jacobs;H126;2;74;80701449;84891847;4190398
Jacobs;H126;2;20;86266274;87222916;956642
Jacobs;H126;2;16;101134453;101709271;574818
Jacobs;H126;2;15;110083416;110941391;857975
Jacobs;H126;2;21;121796989;123494681;1697692
Jacobs;H126;2;35;133272817;135337045;2064228
Jacobs;H126;2;108;170058634;176450447;6391813
Jacobs;H126;2;86;186306661;191307142;5000481
Jacobs;H126;2;16;198155571;198824819;669248
Jacobs;H126;2;22;211512445;212806608;1294163
Jacobs;H126;2;24;213674776;215641893;1967117
Jacobs;H126;2;60;217719922;221624187;3904265
Jacobs;H126;2;42;221940916;224027318;2086402
Jacobs;H126;2;28;230439460;232022650;1583190
Jacobs;H126;10;49;10108612;13015377;2906765
Jacobs;H126;10;50;14894636;17651675;2757039
Jacobs;H126;10;24;22454477;23673666;1219189
Jacobs;H126;10;95;27701281;32465060;4763779
Jacobs;H126;10;18;36448017;37738237;1290220
Jacobs;H126;10;20;38727795;40071898;1344103
Jacobs;H126;10;17;62533112;64310576;1777464
Jacobs;H126;10;29;68694545;70162514;1467969
Jacobs;H126;10;181;71470411;81307769;9837358
Jacobs;H126;10;23;83964085;85263429;1299344
Jacobs;H126;24;17;15762894;17133716;1370822
Jacobs;H126;24;42;28877449;31947993;3070544
Jacobs;H126;24;29;39603557;42027686;2424129
Jacobs;H127;2;31;4431496;5940814;1509318
Jacobs;H127;2;17;21789864;22493681;703817
Jacobs;H127;2;42;31712060;34096217;2384157
Jacobs;H127;2;27;45320994;47352919;2031925
Jacobs;H127;2;51;54135888;56751008;2615120
Jacobs;H127;2;19;72875158;73926990;1051832
Jacobs;H127;2;36;79183271;80967126;1783855
Jacobs;H127;2;101;82290592;88172646;5882054
Jacobs;H127;2;47;107035638;109132360;2096722
Jacobs;H127;2;21;121796989;123494681;1697692
Jacobs;H127;2;99;144342270;149768329;5426059
Jacobs;H127;2;108;170058634;176450447;6391813
Jacobs;H127;2;15;198176953;198824819;647866
Jacobs;H127;2;22;211512445;212806608;1294163
Jacobs;H127;2;24;213674776;215641893;1967117
Jacobs;H127;2;60;217719922;221624187;3904265
Jacobs;H127;2;42;221940916;224027318;2086402
Jacobs;H127;2;28;230439460;232022650;1583190
Jacobs;H127;2;29;238041313;239510065;1468752
Jacobs;H127;10;49;10108612;13015377;2906765
Jacobs;H127;10;50;14894636;17651675;2757039
Jacobs;H127;10;24;22454477;23673666;1219189
Jacobs;H127;10;111;27701281;33533969;5832688
Jacobs;H127;10;18;36448017;37738237;1290220
Jacobs;H127;10;20;38727795;40071898;1344103
Jacobs;H127;10;49;49876303;52419746;2543443
Jacobs;H127;10;17;62533112;64310576;1777464
Jacobs;H127;10;29;68694545;70162514;1467969
Jacobs;H127;10;45;71470411;74308075;2837664
Jacobs;H127;10;43;82994149;85162550;2168401
Jacobs;H127;24;42;28877449;31947993;3070544
Jacobs;H127;24;25;39603557;41143981;1540424
Jacobs;H128;2;31;4431496;5940814;1509318
Jacobs;H128;2;17;21789864;22493681;703817
Jacobs;H128;2;42;31712060;34096217;2384157
Jacobs;H128;2;18;49220327;49993837;773510
Jacobs;H128;2;142;52266474;59306755;7040281
Jacobs;H128;2;29;66730561;68326509;1595948
Jacobs;H128;2;204;69626926;80904183;11277257
Jacobs;H128;2;32;86266274;87906063;1639789
Jacobs;H128;2;18;101030254;101709271;679017
Jacobs;H128;2;15;110083416;110941391;857975
Jacobs;H128;2;21;121796989;123494681;1697692
Jacobs;H128;2;35;133272817;135337045;2064228
Jacobs;H128;2;23;168719169;170000512;1281343
Jacobs;H128;2;23;215994089;218592494;2598405
Jacobs;H128;2;41;219357404;221711968;2354564
Jacobs;H128;2;99;223876023;229097219;5221196
Jacobs;H128;2;28;230439460;232022650;1583190
Jacobs;H128;2;44;238041313;240409281;2367968
Jacobs;H128;2;15;241839716;242738945;899229
Jacobs;H128;10;15;10155086;10839165;684079
Jacobs;H128;10;50;14894636;17651675;2757039
Jacobs;H128;10;16;22713402;23445044;731642
Jacobs;H128;10;201;32773769;45845544;13071775
Jacobs;H128;10;44;52051123;54623451;2572328
Jacobs;H128;10;15;65960957;66643472;682515
Jacobs;H128;10;45;71470411;74308075;2837664
Jacobs;H128;10;43;82994149;85162550;2168401
Jacobs;H128;24;26;4000350;5785403;1785053
Jacobs;H128;24;17;15762894;17133716;1370822
Jacobs;H128;24;84;25107237;31359697;6252460
Jacobs;H128;24;17;33879086;35216176;1337090
Jacobs;H129;2;15;4080987;4670884;589897
Jacobs;H129;2;198;33980393;46294279;12313886
Jacobs;H129;2;16;52327990;53043790;715800
Jacobs;H129;2;19;53986551;54687816;701265
Jacobs;H129;2;17;56446750;57307599;860849
Jacobs;H129;2;1240;75745623;147996276;72250653
Jacobs;H129;2;369;148213917;169169208;20955291
Jacobs;H129;2;16;178388511;179521559;1133048
Jacobs;H129;2;74;181751292;186224877;4473585
Jacobs;H129;2;17;198875303;199681176;805873
Jacobs;H129;2;18;215443702;217457102;2013400
Jacobs;H129;10;56;24378713;27365899;2987186
Jacobs;H129;10;18;31493771;32637918;1144147
Jacobs;H129;10;146;35566480;45845544;10279064
Jacobs;H129;10;26;55319894;56946876;1626982
Jacobs;H129;10;164;60005994;70162514;10156520
Jacobs;H129;10;107;71470411;77411116;5940705
Jacobs;H129;10;46;82083004;84537988;2454984
Jacobs;H129;24;20;11076801;12558998;1482197
Jacobs;H129;24;16;16041579;17253902;1212323
Jacobs;H129;24;54;19347886;24060526;4712640
Jacobs;H130;2;41;945715;2991783;2046068
Jacobs;H130;2;86;54135888;58258740;4122852
Jacobs;H130;2;21;65402955;66608553;1205598
Jacobs;H130;2;27;66858417;68326509;1468092
Jacobs;H130;2;32;75644823;77328509;1683686
Jacobs;H130;2;36;79183271;80967126;1783855
Jacobs;H130;2;101;82290592;88172646;5882054
Jacobs;H130;2;18;101030254;101709271;679017
Jacobs;H130;2;15;110083416;110941391;857975
Jacobs;H130;2;21;121796989;123494681;1697692
Jacobs;H130;2;35;133272817;135337045;2064228
Jacobs;H130;2;23;142709866;144170136;1460270
Jacobs;H130;2;25;162492078;163845372;1353294
Jacobs;H130;2;18;165399749;166276060;876311
Jacobs;H130;2;101;170563260;176450447;5887187
Jacobs;H130;2;16;198155571;198824819;669248
Jacobs;H130;2;22;211512445;212806608;1294163
Jacobs;H130;2;24;213674776;215641893;1967117
Jacobs;H130;2;60;217719922;221624187;3904265
Jacobs;H130;2;42;221940916;224027318;2086402
Jacobs;H130;2;84;225936196;230439460;4503264
Jacobs;H130;10;68;14894636;18737350;3842714
Jacobs;H130;10;22;19096234;20329835;1233601
Jacobs;H130;10;22;22713402;23865906;1152504
Jacobs;H130;10;201;32773769;45845544;13071775
Jacobs;H130;10;44;52051123;54623451;2572328
Jacobs;H130;10;15;65960957;66643472;682515
Jacobs;H130;10;45;71470411;74308075;2837664
Jacobs;H130;10;44;82994149;85263429;2269280
Jacobs;H130;24;17;15762894;17133716;1370822
Jacobs;H130;24;42;28877449;31947993;3070544
Jacobs;H130;24;29;39603557;42027686;2424129
Jacobs;H131;2;31;1606489;2991783;1385294
Jacobs;H131;2;20;10206141;10967299;761158
Jacobs;H131;2;57;31362675;34615665;3252990
Jacobs;H131;2;16;41262244;42499181;1236937
Jacobs;H131;2;21;44461037;45493819;1032782
Jacobs;H131;2;16;64542824;65324896;782072
Jacobs;H131;2;18;70721438;71739429;1017991
Jacobs;H131;2;15;73109758;73839087;729329
Jacobs;H131;2;15;121734938;123048197;1313259
Jacobs;H131;2;28;124262151;125383356;1121205
Jacobs;H131;2;39;138618372;140560157;1941785
Jacobs;H131;2;21;168719169;169929278;1210109
Jacobs;H131;2;22;177580706;178764936;1184230
Jacobs;H131;2;39;184760567;187259707;2499140
Jacobs;H131;2;61;193151043;197093416;3942373
Jacobs;H131;2;39;199432096;201797379;2365283
Jacobs;H131;2;18;205244432;206276753;1032321
Jacobs;H131;2;50;211512445;215251657;3739212
Jacobs;H131;2;52;215844761;220852308;5007547
Jacobs;H131;2;16;223012717;223762044;749327
Jacobs;H131;2;31;241748973;243490742;1741769
Jacobs;H131;10;15;12770970;13560775;789805
Jacobs;H131;10;68;29238591;32637918;3399327
Jacobs;H131;10;29;36883392;39489315;2605923
Jacobs;H131;10;18;40149974;40971187;821213
Jacobs;H131;10;22;47662790;48594445;931655
Jacobs;H131;10;43;82994149;85162550;2168401
Jacobs;H131;24;18;12496861;13767641;1270780
Jacobs;H131;24;19;16041579;17460873;1419294
Jacobs;H131;24;15;20909487;22222030;1312543
Jacobs;H131;24;28;32681863;34176391;1494528
Jacobs;H131;24;26;36250095;38125663;1875568
Jacobs;H132;2;248;26664802;42499181;15834379
Jacobs;H132;2;413;54135888;76732322;22596434
Jacobs;H132;2;16;79000514;80032995;1032481
Jacobs;H132;2;42;84054194;86582074;2527880
Jacobs;H132;2;18;108309773;109132360;822587
Jacobs;H132;2;17;110606314;112190964;1584650
Jacobs;H132;2;36;114106580;116350674;2244094
Jacobs;H132;2;16;116635922;117464089;828167
Jacobs;H132;2;23;122001925;123573014;1571089
Jacobs;H132;2;41;126622908;128843993;2221085
Jacobs;H132;2;23;130368989;131682707;1313718
Jacobs;H132;2;32;132635669;134244380;1608711
Jacobs;H132;2;16;134667278;135446006;778728
Jacobs;H132;2;24;148986290;150059057;1072767
Jacobs;H132;2;31;162689295;164308657;1619362
Jacobs;H132;2;34;204702992;206427786;1724794
Jacobs;H132;2;98;207548922;212806608;5257686
Jacobs;H132;2;37;213505877;217457102;3951225
Jacobs;H132;2;19;218058406;219468105;1409699
Jacobs;H132;2;17;219847222;220955491;1108269
Jacobs;H132;2;16;243365308;244608420;1243112
Jacobs;H132;10;84;10155086;14924805;4769719
Jacobs;H132;10;34;32818994;34536188;1717194
Jacobs;H132;10;16;36637311;37738237;1100926
Jacobs;H132;10;34;41802553;44519802;2717249
Jacobs;H132;10;25;48323497;49344061;1020564
Jacobs;H132;10;76;74078020;77908724;3830704
Jacobs;H132;10;28;84029946;85596458;1566512
Jacobs;H132;24;19;15551549;16957079;1405530
Jacobs;H132;24;17;19946691;21392558;1445867
Jacobs;H132;24;16;31556086;32390507;834421
Jacobs;H133;2;58;158066;3603417;3445351
Jacobs;H133;2;16;10266961;10887825;620864
Jacobs;H133;2;186;15181363;24861755;9680392
Jacobs;H133;2;71;45320994;49646230;4325236
Jacobs;H133;2;34;51720147;53366034;1645887
Jacobs;H133;2;15;55136707;55995982;859275
Jacobs;H133;2;60;68216266;71739429;3523163
Jacobs;H133;2;15;73109758;73839087;729329
Jacobs;H133;2;63;95385937;99487592;4101655
Jacobs;H133;2;17;110875234;112943535;2068301
Jacobs;H133;2;22;114411448;115784285;1372837
Jacobs;H133;2;17;115912934;117115355;1202421
Jacobs;H133;2;41;133272817;135576714;2303897
Jacobs;H133;2;71;140104951;144021471;3916520
Jacobs;H133;2;44;147210213;149666645;2456432
Jacobs;H133;2;224;179799000;193045812;13246812
Jacobs;H133;2;55;193433380;197093416;3660036
Jacobs;H133;2;134;207040648;215251657;8211009
Jacobs;H133;2;36;215844761;219774612;3929851
Jacobs;H133;2;20;220083076;221153389;1070313
Jacobs;H133;2;17;238831242;239616700;785458
Jacobs;H133;10;16;10010195;10799783;789588
Jacobs;H133;10;44;14523808;17061324;2537516
Jacobs;H133;10;17;18737350;19689245;951895
Jacobs;H133;10;17;21431009;22376804;945795
Jacobs;H133;10;18;36448017;37738237;1290220
Jacobs;H133;10;20;38727795;40071898;1344103
Jacobs;H133;10;18;82445757;83277025;831268
Jacobs;H133;24;25;11007102;12952274;1945172
Jacobs;H133;24;72;27620251;32495625;4875374
Jacobs;H133;24;20;33313461;34176391;862930
Jacobs;H133;24;74;36250095;42027686;5777591
Jacobs;H134;2;28;25481746;27284017;1802271
Jacobs;H134;2;16;52327990;53043790;715800
Jacobs;H134;2;19;53986551;54687816;701265
Jacobs;H134;2;105;70548455;76783372;6234917
Jacobs;H134;2;19;80262318;80967126;704808
Jacobs;H134;2;17;94981400;96022899;1041499
Jacobs;H134;2;18;108309773;109132360;822587
Jacobs;H134;2;17;110606314;112190964;1584650
Jacobs;H134;2;25;114883685;116350674;1466989
Jacobs;H134;2;16;116635922;117464089;828167
Jacobs;H134;2;23;122001925;123573014;1571089
Jacobs;H134;2;88;128625705;133040292;4414587
Jacobs;H134;2;28;170856163;172424726;1568563
Jacobs;H134;2;605;179348624;215098553;35749929
Jacobs;H134;2;18;215443702;217457102;2013400
Jacobs;H134;2;17;219847222;220955491;1108269
Jacobs;H134;2;31;238831242;240477448;1646206
Jacobs;H134;2;16;246121938;246737445;615507
Jacobs;H134;10;18;12956525;13855191;898666
Jacobs;H134;10;106;16216118;22285343;6069225
Jacobs;H134;10;34;41802553;44519802;2717249
Jacobs;H134;10;38;48323497;50071084;1747587
Jacobs;H134;10;20;67493967;68757883;1263916
Jacobs;H134;10;23;83964085;85263429;1299344
Jacobs;H134;24;19;15865169;17307132;1441963
Jacobs;H134;24;35;26493858;29197813;2703955
Jacobs;H135;2;15;24966147;25765503;799356
Jacobs;H135;2;51;54135888;56751008;2615120
Jacobs;H135;2;43;80262318;82192970;1930652
Jacobs;H135;2;25;84141589;85875802;1734213
Jacobs;H135;2;18;100934715;101600940;666225
Jacobs;H135;2;20;108235636;109132360;896724
Jacobs;H135;2;19;116203332;117314510;1111178
Jacobs;H135;2;27;122001925;123740047;1738122
Jacobs;H135;2;15;135590631;136512593;921962
Jacobs;H135;2;48;147210213;149923043;2712830
Jacobs;H135;2;71;150948753;155337073;4388320
Jacobs;H135;2;47;172699752;175418941;2719189
Jacobs;H135;2;117;199432096;205572258;6140162
Jacobs;H135;2;15;236541718;237613535;1071817
Jacobs;H135;10;25;6551668;8904686;2353018
Jacobs;H135;10;23;18389301;19700851;1311550
Jacobs;H135;10;199;22053544;32637918;10584374
Jacobs;H135;10;155;36883392;47487991;10604599
Jacobs;H135;10;40;47662790;49344061;1681271
Jacobs;H135;10;84;73373701;77411116;4037415
Jacobs;H135;10;17;83421733;84297326;875593
Jacobs;H135;24;24;5232180;6526499;1294319
Jacobs;H135;24;74;11076801;16147749;5070948
Jacobs;H135;24;77;18056244;24629625;6573381
Jacobs;H135;24;65;31821433;36076909;4255476
Jacobs;H136;2;1099;158066;62482737;62324671
Jacobs;H136;2;18;91276899;92162531;885632
Jacobs;H136;2;49;99302002;101684673;2382671
Jacobs;H136;2;20;108235636;109132360;896724
Jacobs;H136;2;24;113897647;115665643;1767996
Jacobs;H136;2;23;122001925;123573014;1571089
Jacobs;H136;2;15;135636519;136565040;928521
Jacobs;H136;2;71;150948753;155337073;4388320
Jacobs;H136;2;16;178388511;179521559;1133048
Jacobs;H136;2;75;181751292;186306661;4555369
Jacobs;H136;2;17;198875303;199681176;805873
Jacobs;H136;2;16;215443702;216807667;1363965
Jacobs;H136;10;66;10922307;14856146;3933839
Jacobs;H136;10;23;21126901;22376804;1249903
Jacobs;H136;10;16;25034802;25827394;792592
Jacobs;H136;10;15;26736937;27365899;628962
Jacobs;H136;10;18;31493771;32637918;1144147
Jacobs;H136;10;146;35566480;45845544;10279064
Jacobs;H136;10;26;55319894;56946876;1626982
Jacobs;H136;10;164;60005994;70162514;10156520
Jacobs;H136;10;127;71470411;78520137;7049726
Jacobs;H136;24;20;2043961;3507572;1463611
Jacobs;H137;2;52;1606489;4166902;2560413
Jacobs;H137;2;27;25481746;27218367;1736621
Jacobs;H137;2;16;52327990;53043790;715800
Jacobs;H137;2;19;53986551;54687816;701265
Jacobs;H137;2;105;70548455;76783372;6234917
Jacobs;H137;2;19;80262318;80967126;704808
Jacobs;H137;2;31;82557618;84580673;2023055
Jacobs;H137;2;17;94981400;96022899;1041499
Jacobs;H137;2;18;108309773;109132360;822587
Jacobs;H137;2;17;110606314;112190964;1584650
Jacobs;H137;2;25;114883685;116350674;1466989
Jacobs;H137;2;16;116635922;117464089;828167
Jacobs;H137;2;23;122001925;123573014;1571089
Jacobs;H137;2;88;128625705;133040292;4414587
Jacobs;H137;2;22;136842711;138081646;1238935
Jacobs;H137;2;18;139718962;140468415;749453
Jacobs;H137;2;41;141604180;144021471;2417291
Jacobs;H137;2;139;155064316;163070840;8006524
Jacobs;H137;2;609;182923305;220103004;37179699
Jacobs;H137;2;36;225783164;227781732;1998568
Jacobs;H137;2;16;231543005;232414241;871236
Jacobs;H137;2;16;232591652;233623788;1032136
Jacobs;H137;2;31;241649475;243449101;1799626
Jacobs;H137;2;26;246116878;247245173;1128295
Jacobs;H137;10;16;20329835;21273163;943328
Jacobs;H137;10;18;21927581;22886663;959082
Jacobs;H137;10;18;36448017;37738237;1290220
Jacobs;H137;10;20;38727795;40071898;1344103
Jacobs;H137;10;40;48323497;50290499;1967002
Jacobs;H137;10;23;52768972;54375509;1606537
Jacobs;H137;10;107;71470411;77411116;5940705
Jacobs;H137;24;74;26493858;31947993;5454135
Jacobs;H138;2;70;1606489;4835268;3228779
Jacobs;H138;2;529;24756265;56751008;31994743
Jacobs;H138;2;18;92454972;93425673;970701
Jacobs;H138;2;21;121796989;123494681;1697692
Jacobs;H138;2;58;127306102;130606432;3300330
Jacobs;H138;2;36;133272817;135391568;2118751
Jacobs;H138;2;15;139800218;140468415;668197
Jacobs;H138;2;24;141604180;142963793;1359613
Jacobs;H138;2;15;167511192;168264380;753188
Jacobs;H138;2;16;190574847;191319781;744934
Jacobs;H138;2;113;208020229;215098553;7078324
Jacobs;H138;2;16;215443702;216807667;1363965
Jacobs;H138;2;24;233775867;235184763;1408896
Jacobs;H138;2;18;239564082;240647987;1083905
Jacobs;H138;2;15;241371128;242316517;945389
Jacobs;H138;10;15;6551668;8114054;1562386
Jacobs;H138;10;17;18707689;19637375;929686
Jacobs;H138;10;25;21682188;22997802;1315614
Jacobs;H138;10;82;29202499;33533969;4331470
Jacobs;H138;10;34;41802553;44519802;2717249
Jacobs;H138;10;25;48323497;49344061;1020564
Jacobs;H138;10;49;49876303;52419746;2543443
Jacobs;H138;10;40;57089480;59813838;2724358
Jacobs;H138;10;23;83964085;85263429;1299344
Jacobs;H138;24;59;5593329;8842899;3249570
Jacobs;H138;24;15;34460565;35991517;1530952
Jacobs;H139;2;16;16264144;17033754;769610
Jacobs;H139;2;22;24524166;25481746;957580
Jacobs;H139;2;27;49602010;51384849;1782839
Jacobs;H139;2;16;64459393;65203824;744431
Jacobs;H139;2;21;65402955;66608553;1205598
Jacobs;H139;2;27;66858417;68326509;1468092
Jacobs;H139;2;22;72875158;74090507;1215349
Jacobs;H139;2;55;84054194;87222916;3168722
Jacobs;H139;2;18;101030254;101709271;679017
Jacobs;H139;2;15;110083416;110941391;857975
Jacobs;H139;2;21;121796989;123494681;1697692
Jacobs;H139;2;50;132635669;135337045;2701376
Jacobs;H139;2;26;149768329;151345671;1577342
Jacobs;H139;2;23;158290735;159916624;1625889
Jacobs;H139;2;15;164745318;165486783;741465
Jacobs;H139;2;70;187856073;191673164;3817091
Jacobs;H139;2;15;193197692;193999697;802005
Jacobs;H139;2;15;203751286;204502491;751205
Jacobs;H139;2;27;205244432;206821701;1577269
Jacobs;H139;2;22;211512445;212806608;1294163
Jacobs;H139;2;24;213674776;215641893;1967117
Jacobs;H139;2;60;217719922;221624187;3904265
Jacobs;H139;2;42;221940916;224027318;2086402
Jacobs;H139;2;84;225936196;230439460;4503264
Jacobs;H139;10;15;10155086;10839165;684079
Jacobs;H139;10;50;14894636;17651675;2757039
Jacobs;H139;10;16;22713402;23445044;731642
Jacobs;H139;10;201;32773769;45845544;13071775
Jacobs;H139;10;41;52051123;54459673;2408550
Jacobs;H139;10;18;67493967;68694545;1200578
Jacobs;H139;10;35;74078020;75746175;1668155
Jacobs;H139;24;74;26493858;31947993;5454135
Jacobs;H140;2;23;9589549;10610698;1021149
Jacobs;H140;2;19;30485387;31353780;868393
Jacobs;H140;2;17;45092839;46163449;1070610
Jacobs;H140;2;31;46648569;49009193;2360624
Jacobs;H140;2;27;49602010;51384849;1782839
Jacobs;H140;2;16;64771512;65574894;803382
Jacobs;H140;2;29;67963504;69441272;1477768
Jacobs;H140;2;19;70664942;71739429;1074487
Jacobs;H140;2;15;73109758;73839087;729329
Jacobs;H140;2;167;75644823;84580673;8935850
Jacobs;H140;2;51;94981400;98156393;3174993
Jacobs;H140;2;381;102979198;126384559;23405361
Jacobs;H140;2;73;140622573;144672338;4049765
Jacobs;H140;2;22;211512445;212806608;1294163
Jacobs;H140;2;24;213674776;215641893;1967117
Jacobs;H140;2;107;217719922;224027318;6307396
Jacobs;H140;2;16;231543005;232414241;871236
Jacobs;H140;2;16;232591652;233623788;1032136
Jacobs;H140;10;16;6883264;8495362;1612098
Jacobs;H140;10;15;26736937;27365899;628962
Jacobs;H140;10;33;32773769;34386151;1612382
Jacobs;H140;10;32;36770781;39489315;2718534
Jacobs;H140;10;18;46618259;47487991;869732
Jacobs;H140;10;24;60005994;61166936;1160942
Jacobs;H140;10;23;75314642;76428043;1113401
Jacobs;H140;10;16;77210348;78093080;882732
Jacobs;H140;24;74;12129478;17307132;5177654
Jacobs;H141;2;15;4080987;4670884;589897
Jacobs;H141;2;29;6349125;8180894;1831769
Jacobs;H141;2;18;10649928;11555842;905914
Jacobs;H141;2;44;12597644;14837808;2240164
Jacobs;H141;2;19;16487040;17482057;995017
Jacobs;H141;2;49;26664802;30051860;3387058
Jacobs;H141;2;19;30485387;31353780;868393
Jacobs;H141;2;17;45092839;46163449;1070610
Jacobs;H141;2;31;46648569;49009193;2360624
Jacobs;H141;2;27;49602010;51384849;1782839
Jacobs;H141;2;28;55160910;56751008;1590098
Jacobs;H141;2;22;72875158;74090507;1215349
Jacobs;H141;2;692;87077242;128972285;41895043
Jacobs;H141;2;15;130009715;130831021;821306
Jacobs;H141;2;35;133272817;135337045;2064228
Jacobs;H141;2;18;150249776;151345671;1095895
Jacobs;H141;2;68;152160860;156230655;4069795
Jacobs;H141;2;22;176405730;177951142;1545412
Jacobs;H141;2;199;187856073;199225518;11369445
Jacobs;H141;2;45;238041313;240477448;2436135
Jacobs;H141;10;16;6883264;8495362;1612098
Jacobs;H141;10;15;26736937;27365899;628962
Jacobs;H141;10;33;32773769;34386151;1612382
Jacobs;H141;10;32;36770781;39489315;2718534
Jacobs;H141;10;18;46618259;47487991;869732
Jacobs;H141;10;61;66144695;69596499;3451804
Jacobs;H141;10;31;74131332;75620051;1488719
Jacobs;H141;10;17;77210348;78140084;929736
Jacobs;H141;24;15;8556294;9268996;712702
Jacobs;H141;24;45;28877449;32163368;3285919
Jacobs;H142;2;70;1606489;4835268;3228779
Jacobs;H142;2;30;24756265;26438460;1682195
Jacobs;H142;2;22;29409606;30698479;1288873
Jacobs;H142;2;105;70548455;76783372;6234917
Jacobs;H142;2;19;80262318;80967126;704808
Jacobs;H142;2;16;94561848;95129267;567419
Jacobs;H142;2;17;103466624;104364614;897990
Jacobs;H142;2;30;121607287;123644129;2036842
Jacobs;H142;2;23;130368989;131682707;1313718
Jacobs;H142;2;29;139427894;140785606;1357712
Jacobs;H142;2;30;149553962;151345671;1791709
Jacobs;H142;2;23;168719169;170000512;1281343
Jacobs;H142;2;340;172616581;193433380;20816799
Jacobs;H142;2;113;208020229;215098553;7078324
Jacobs;H142;2;16;215443702;216807667;1363965
Jacobs;H142;2;31;238831242;240477448;1646206
Jacobs;H142;2;26;246116878;247245173;1128295
Jacobs;H142;10;18;12956525;13855191;898666
Jacobs;H142;10;106;16216118;22285343;6069225
Jacobs;H142;10;18;36448017;37738237;1290220
Jacobs;H142;10;20;38727795;40071898;1344103
Jacobs;H142;10;40;48323497;50290499;1967002
Jacobs;H142;10;38;52101841;54375509;2273668
Jacobs;H142;10;44;56906392;59813838;2907446
Jacobs;H142;10;25;68900227;70162514;1262287
Jacobs;H142;10;45;71470411;74308075;2837664
Jacobs;H142;10;21;77507372;78599973;1092601
Jacobs;H142;10;22;79312434;80519356;1206922
Jacobs;H142;10;15;84774726;85580441;805715
Jacobs;H142;24;19;15865169;17307132;1441963
Jacobs;H142;24;35;26493858;29197813;2703955
Jacobs;H143;2;16;10266961;10887825;620864
Jacobs;H143;2;22;19128677;20209570;1080893
Jacobs;H143;2;38;25939009;28578328;2639319
Jacobs;H143;2;19;65876876;67012655;1135779
Jacobs;H143;2;37;67534697;69441272;1906575
Jacobs;H143;2;19;70664942;71739429;1074487
Jacobs;H143;2;191;116350674;126926047;10575373
Jacobs;H143;2;60;129421996;132550706;3128710
Jacobs;H143;2;34;142709866;144672338;1962472
Jacobs;H143;2;276;157252102;173034908;15782806
Jacobs;H143;2;27;180080977;182097199;2016222
Jacobs;H143;2;17;199076879;199942549;865670
Jacobs;H143;2;32;215443702;218309332;2865630
Jacobs;H143;2;54;219933911;222800960;2867049
Jacobs;H143;2;16;223012717;223762044;749327
Jacobs;H143;2;16;238831242;239564082;732840
Jacobs;H143;10;27;16196817;17481523;1284706
Jacobs;H143;10;32;21682188;23289566;1607378
Jacobs;H143;10;68;25827394;29502667;3675273
Jacobs;H143;10;34;41802553;44519802;2717249
Jacobs;H143;10;38;48323497;50071084;1747587
Jacobs;H143;10;61;66144695;69596499;3451804
Jacobs;H143;10;66;74131332;77411116;3279784
Jacobs;H143;10;43;82994149;85162550;2168401
Jacobs;H143;24;19;15865169;17307132;1441963
Jacobs;H143;24;35;26493858;29197813;2703955
Jacobs;H144;2;53;2278905;4670884;2391979
Jacobs;H144;2;16;18903649;19654697;751048
Jacobs;H144;2;15;24966147;25765503;799356
Jacobs;H144;2;51;54135888;56751008;2615120
Jacobs;H144;2;95;75626143;80421373;4795230
Jacobs;H144;2;76;85589367;89818428;4229061
Jacobs;H144;2;17;103407822;104281644;873822
Jacobs;H144;2;30;121607287;123644129;2036842
Jacobs;H144;2;40;125273857;127088467;1814610
Jacobs;H144;2;74;129353026;133040292;3687266
Jacobs;H144;2;54;143864562;146856560;2991998
Jacobs;H144;2;139;155064316;163070840;8006524
Jacobs;H144;2;23;168719169;170000512;1281343
Jacobs;H144;2;48;215594803;220103004;4508201
Jacobs;H144;2;16;223012717;223762044;749327
Jacobs;H144;2;15;230006689;230823473;816784
Jacobs;H144;2;138;231069887;238899861;7829974
Jacobs;H144;10;131;14813653;22376804;7563151
Jacobs;H144;10;16;25034802;25827394;792592
Jacobs;H144;10;15;26736937;27365899;628962
Jacobs;H144;10;126;31493771;39489315;7995544
Jacobs;H144;10;19;40105937;40971187;865250
Jacobs;H144;10;40;47662790;49344061;1681271
Jacobs;H144;10;84;73373701;77411116;4037415
Jacobs;H144;10;17;83421733;84297326;875593
Jacobs;H144;24;15;16077497;17253902;1176405
Jacobs;H145;2;45;2278905;4351718;2072813
Jacobs;H145;2;35;13473852;15141339;1667487
Jacobs;H145;2;64;16172689;19404154;3231465
Jacobs;H145;2;40;46219946;49009193;2789247
Jacobs;H145;2;31;60131740;61875935;1744195
Jacobs;H145;2;73;62820094;66608553;3788459
Jacobs;H145;2;34;69626926;71739429;2112503
Jacobs;H145;2;15;73109758;73839087;729329
Jacobs;H145;2;25;87257501;88447935;1190434
Jacobs;H145;2;24;108309773;109487038;1177265
Jacobs;H145;2;21;116265153;117413762;1148609
Jacobs;H145;2;15;121734938;123048197;1313259
Jacobs;H145;2;64;124133864;127070041;2936177
Jacobs;H145;2;23;127495017;128843993;1348976
Jacobs;H145;2;51;132635669;135391568;2755899
Jacobs;H145;2;25;136654969;138081646;1426677
Jacobs;H145;2;53;140158515;142963793;2805278
Jacobs;H145;2;15;161998965;162572509;573544
Jacobs;H145;2;23;215251657;217457102;2205445
Jacobs;H145;2;20;236285593;237613535;1327942
Jacobs;H145;10;45;14485571;17061324;2575753
Jacobs;H145;10;18;18707689;19689245;981556
Jacobs;H145;10;24;22454477;23673666;1219189
Jacobs;H145;10;111;27701281;33533969;5832688
Jacobs;H145;10;18;36448017;37738237;1290220
Jacobs;H145;10;20;38727795;40071898;1344103
Jacobs;H145;10;49;49876303;52419746;2543443
Jacobs;H145;10;20;68271380;69311273;1039893
Jacobs;H145;10;18;71470411;72901888;1431477
Jacobs;H145;10;88;74078020;78520137;4442117
Jacobs;H145;10;41;78803876;80865534;2061658
Jacobs;H145;10;18;82445757;83277025;831268
Jacobs;H146;2;45;2278905;4351718;2072813
Jacobs;H146;2;71;5011935;9266747;4254812
Jacobs;H146;2;258;16172689;30785949;14613260
Jacobs;H146;2;30;46648569;48930164;2281595
Jacobs;H146;2;83;50949347;55415073;4465726
Jacobs;H146;2;15;73109758;73839087;729329
Jacobs;H146;2;80;84705740;88789712;4083972
Jacobs;H146;2;83;95385937;100774009;5388072
Jacobs;H146;2;15;121734938;123048197;1313259
Jacobs;H146;2;51;124133864;126384559;2250695
Jacobs;H146;2;51;132635669;135391568;2755899
Jacobs;H146;2;22;136654969;137832529;1177560
Jacobs;H146;2;251;157462596;171889296;14426700
Jacobs;H146;2;17;172616581;173532404;915823
Jacobs;H146;2;56;184565642;188204145;3638503
Jacobs;H146;2;109;193433380;199942549;6509169
Jacobs;H146;2;134;207040648;215251657;8211009
Jacobs;H146;2;52;215844761;220852308;5007547
Jacobs;H146;10;15;2329436;2953668;624232
Jacobs;H146;10;16;12770970;13579925;808955
Jacobs;H146;10;16;14007878;14813653;805775
Jacobs;H146;10;46;18737350;21431009;2693659
Jacobs;H146;10;30;21927581;23604001;1676420
Jacobs;H146;10;16;25034802;25827394;792592
Jacobs;H146;10;15;26736937;27365899;628962
Jacobs;H146;10;271;31732075;48594445;16862370
Jacobs;H146;10;15;51140627;51707941;567314
Jacobs;H146;10;15;75064512;75778400;713888
Jacobs;H146;10;20;76502321;77411116;908795
Jacobs;H146;10;17;84741018;85596458;855440
Jacobs;H146;24;109;5593329;12952274;7358945
Jacobs;H147;2;271;158066;15141339;14983273
Jacobs;H147;2;21;16416165;17482057;1065892
Jacobs;H147;2;60;36971592;41162381;4190789
Jacobs;H147;2;18;49220327;49993837;773510
Jacobs;H147;2;23;53528684;54596587;1067903
Jacobs;H147;2;1344;55160910;132550706;77389796
Jacobs;H147;2;34;142709866;144672338;1962472
Jacobs;H147;2;75;167111471;171362036;4250565
Jacobs;H147;2;15;176695897;177580706;884809
Jacobs;H147;2;17;199076879;199942549;865670
Jacobs;H147;2;316;201140943;220955491;19814548
Jacobs;H147;2;15;241839716;242738945;899229
Jacobs;H147;10;19;22713402;23673666;960264
Jacobs;H147;10;29;36883392;39489315;2605923
Jacobs;H147;10;18;40149974;40971187;821213
Jacobs;H147;10;18;46618259;47487991;869732
Jacobs;H147;10;41;50920778;52630202;1709424
Jacobs;H147;10;25;52768972;54459673;1690701
Jacobs;H147;10;17;67493967;68597311;1103344
Jacobs;H147;24;25;15100676;16811910;1711234
Jacobs;H147;24;16;20189283;21460746;1271463
Jacobs;H147;24;40;28877449;31899729;3022280
Jacobs;H147;24;28;32495625;33953578;1457953
Jacobs;H148;2;15;4080987;4670884;589897
Jacobs;H148;2;50;12597644;15141339;2543695
Jacobs;H148;2;21;16416165;17482057;1065892
Jacobs;H148;2;685;34584226;73839087;39254861
Jacobs;H148;2;55;84054194;87222916;3168722
Jacobs;H148;2;24;117369115;119081713;1712598
Jacobs;H148;2;21;121796989;123494681;1697692
Jacobs;H148;2;35;133272817;135337045;2064228
Jacobs;H148;2;62;148581376;151888029;3306653
Jacobs;H148;2;108;170058634;176450447;6391813
Jacobs;H148;2;15;198176953;198824819;647866
Jacobs;H148;2;22;211512445;212806608;1294163
Jacobs;H148;2;24;213674776;215641893;1967117
Jacobs;H148;2;28;215844761;219015064;3170303
Jacobs;H148;2;17;219847222;220955491;1108269
Jacobs;H148;2;15;236449805;237488816;1039011
Jacobs;H148;2;15;244129054;244947713;818659
Jacobs;H148;10;352;14894636;34175819;19281183
Jacobs;H148;10;18;36448017;37738237;1290220
Jacobs;H148;10;20;38727795;40071898;1344103
Jacobs;H148;10;51;49755696;52419746;2664050
Jacobs;H148;10;17;58143024;59691651;1548627
Jacobs;H148;10;18;67493967;68694545;1200578
Jacobs;H148;24;17;15762894;17133716;1370822
Jacobs;H148;24;43;28877449;31953567;3076118
Jacobs;H148;24;25;39603557;41143981;1540424
Jacobs;H149;2;109;158066;6092514;5934448
Jacobs;H149;2;31;13307050;14837808;1530758
Jacobs;H149;2;21;16416165;17482057;1065892
Jacobs;H149;2;49;26664802;30051860;3387058
Jacobs;H149;2;86;40790032;46146229;5356197
Jacobs;H149;2;15;49484087;50080258;596171
Jacobs;H149;2;91;58791324;63635636;4844312
Jacobs;H149;2;19;65876876;67012655;1135779
Jacobs;H149;2;37;67534697;69441272;1906575
Jacobs;H149;2;19;70664942;71739429;1074487
Jacobs;H149;2;15;73109758;73839087;729329
Jacobs;H149;2;43;80262318;82192970;1930652
Jacobs;H149;2;17;103407822;104281644;873822
Jacobs;H149;2;39;131397735;133040292;1642557
Jacobs;H149;2;40;140827873;142963793;2135920
Jacobs;H149;2;15;198176953;198824819;647866
Jacobs;H149;2;16;215443702;216807667;1363965
Jacobs;H149;2;15;244129054;244947713;818659
Jacobs;H149;10;16;20329835;21273163;943328
Jacobs;H149;10;16;25034802;25827394;792592
Jacobs;H149;10;15;26736937;27365899;628962
Jacobs;H149;10;201;32773769;45845544;13071775
Jacobs;H149;10;26;55319894;56946876;1626982
Jacobs;H149;10;45;71470411;74308075;2837664
Jacobs;H149;10;21;77507372;78599973;1092601
Jacobs;H149;10;22;79312434;80519356;1206922
Jacobs;H149;10;15;84774726;85580441;805715
Jacobs;H149;24;26;7967370;9268996;1301626
Jacobs;H149;24;21;15324479;16892562;1568083
Jacobs;H150;2;86;29409606;34303557;4893951
Jacobs;H150;2;86;40790032;46146229;5356197
Jacobs;H150;2;15;49484087;50080258;596171
Jacobs;H150;2;25;58791324;60044110;1252786
Jacobs;H150;2;19;65876876;67012655;1135779
Jacobs;H150;2;37;67534697;69441272;1906575
Jacobs;H150;2;19;70664942;71739429;1074487
Jacobs;H150;2;15;73109758;73839087;729329
Jacobs;H150;2;43;80262318;82192970;1930652
Jacobs;H150;2;17;94981400;96022899;1041499
Jacobs;H150;2;22;108072803;109132360;1059557
Jacobs;H150;2;17;110606314;112190964;1584650
Jacobs;H150;2;25;114883685;116350674;1466989
Jacobs;H150;2;16;116635922;117464089;828167
Jacobs;H150;2;23;122001925;123573014;1571089
Jacobs;H150;2;88;128625705;133040292;4414587
Jacobs;H150;2;40;140827873;142963793;2135920
Jacobs;H150;2;15;198176953;198824819;647866
Jacobs;H150;2;16;215443702;216807667;1363965
Jacobs;H150;2;16;231543005;232414241;871236
Jacobs;H150;2;16;232591652;233623788;1032136
Jacobs;H150;2;31;241649475;243449101;1799626
Jacobs;H150;2;26;246116878;247245173;1128295
Jacobs;H150;10;41;14894636;17138817;2244181
Jacobs;H150;10;17;18737350;19689245;951895
Jacobs;H150;10;145;23213276;30849548;7636272
Jacobs;H150;10;18;36448017;37738237;1290220
Jacobs;H150;10;20;38727795;40071898;1344103
Jacobs;H150;10;49;49876303;52419746;2543443
Jacobs;H150;10;17;58143024;59691651;1548627
Jacobs;H150;10;36;68271380;70162514;1891134
Jacobs;H150;10;108;71470411;77507372;6036961
Jacobs;H150;24;21;12496861;13980455;1483594
Jacobs;H150;24;21;15324479;16892562;1568083
Jacobs;H150;24;18;34460565;36160755;1700190
Jacobs;H151;2;61;11476553;14837808;3361255
Jacobs;H151;2;251;16622194;30785949;14163755
Jacobs;H151;2;47;40205877;43558237;3352360
Jacobs;H151;2;30;46648569;48930164;2281595
Jacobs;H151;2;34;51720147;53366034;1645887
Jacobs;H151;2;18;57559602;58198123;638521
Jacobs;H151;2;16;64771512;65574894;803382
Jacobs;H151;2;19;70664942;71739429;1074487
Jacobs;H151;2;15;73109758;73839087;729329
Jacobs;H151;2;17;110875234;112943535;2068301
Jacobs;H151;2;22;114411448;115784285;1372837
Jacobs;H151;2;17;115912934;117115355;1202421
Jacobs;H151;2;52;132635669;135446006;2810337
Jacobs;H151;2;25;136654969;138081646;1426677
Jacobs;H151;2;53;140158515;142963793;2805278
Jacobs;H151;2;44;147210213;149666645;2456432
Jacobs;H151;2;224;179799000;193045812;13246812
Jacobs;H151;2;50;196669044;199225518;2556474
Jacobs;H151;2;19;210948623;211735126;786503
Jacobs;H151;2;16;223812677;224444800;632123
Jacobs;H151;2;15;227373381;228130504;757123
Jacobs;H151;10;15;2329436;2953668;624232
Jacobs;H151;10;82;17481523;22376804;4895281
Jacobs;H151;10;68;29238591;32637918;3399327
Jacobs;H151;10;18;35566480;36526839;960359
Jacobs;H151;10;36;36847123;39942731;3095608
Jacobs;H151;10;30;41210470;43778374;2567904
Jacobs;H151;10;29;47228374;48594445;1366071
Jacobs;H151;10;17;84741018;85596458;855440
Jacobs;H151;24;26;8379806;9942134;1562328
Jacobs;H151;24;18;15637488;17133716;1496228
Jacobs;H151;24;47;23209530;26681408;3471878
Jacobs;H152;2;27;45320994;47352919;2031925
Jacobs;H152;2;51;54135888;56751008;2615120
Jacobs;H152;2;19;70664942;71739429;1074487
Jacobs;H152;2;15;73109758;73839087;729329
Jacobs;H152;2;74;80701449;84891847;4190398
Jacobs;H152;2;20;86266274;87222916;956642
Jacobs;H152;2;177;117369115;127070041;9700926
Jacobs;H152;2;35;133272817;135337045;2064228
Jacobs;H152;2;37;162689295;164594319;1905024
Jacobs;H152;2;17;171889296;172616581;727285
Jacobs;H152;2;15;175346551;176135485;788934
Jacobs;H152;2;19;218058406;219468105;1409699
Jacobs;H152;2;17;219847222;220955491;1108269
Jacobs;H152;2;49;240647987;243449101;2801114
Jacobs;H152;10;750;14894636;58143024;43248388
Jacobs;H152;10;15;65960957;66643472;682515
Jacobs;H152;10;181;71470411;81307769;9837358
Jacobs;H152;10;23;83964085;85263429;1299344
Jacobs;H152;24;17;15762894;17133716;1370822
Jacobs;H152;24;47;17514108;21460746;3946638
Jacobs;H152;24;35;28877449;31359697;2482248
Jacobs;H152;24;17;34345815;36036418;1690603
Jacobs;H153;2;104;16622194;21928040;5305846
Jacobs;H153;2;28;22809937;24157644;1347707
Jacobs;H153;2;20;24756265;25765503;1009238
Jacobs;H153;2;19;39327845;40350901;1023056
Jacobs;H153;2;30;46648569;48930164;2281595
Jacobs;H153;2;16;52327990;53043790;715800
Jacobs;H153;2;16;64771512;65574894;803382
Jacobs;H153;2;20;73508928;74700075;1191147
Jacobs;H153;2;153;77170481;85508894;8338413
Jacobs;H153;2;42;98008059;100774009;2765950
Jacobs;H153;2;47;107035638;109132360;2096722
Jacobs;H153;2;21;121796989;123494681;1697692
Jacobs;H153;2;119;131649580;137832529;6182949
Jacobs;H153;2;34;142709866;144672338;1962472
Jacobs;H153;2;68;152160860;156230655;4069795
Jacobs;H153;2;17;173034908;173910913;876005
Jacobs;H153;2;56;184565642;188204145;3638503
Jacobs;H153;2;19;210948623;211735126;786503
Jacobs;H153;10;16;6551668;8404113;1852445
Jacobs;H153;10;26;21584008;22955949;1371941
Jacobs;H153;10;15;26736937;27365899;628962
Jacobs;H153;10;46;31732075;34386151;2654076
Jacobs;H153;10;32;36770781;39489315;2718534
Jacobs;H153;10;37;47228374;48972916;1744542
Jacobs;H153;10;30;80942406;82225985;1283579
Jacobs;H153;24;52;16077497;20406106;4328609
Jacobs;H154;2;70;1606489;4835268;3228779
Jacobs;H154;2;29;14359717;15741288;1381571
Jacobs;H154;2;24;16264144;17482057;1217913
Jacobs;H154;2;49;26664802;30051860;3387058
Jacobs;H154;2;70;30463448;34303557;3840109
Jacobs;H154;2;86;40790032;46146229;5356197
Jacobs;H154;2;16;52327990;53043790;715800
Jacobs;H154;2;19;53986551;54687816;701265
Jacobs;H154;2;105;70548455;76783372;6234917
Jacobs;H154;2;19;80262318;80967126;704808
Jacobs;H154;2;16;101134453;101709271;574818
Jacobs;H154;2;21;121796989;123494681;1697692
Jacobs;H154;2;58;127306102;130606432;3300330
Jacobs;H154;2;53;131596312;134094336;2498024
Jacobs;H154;2;18;139718962;140468415;749453
Jacobs;H154;2;41;141604180;144021471;2417291
Jacobs;H154;2;139;155064316;163070840;8006524
Jacobs;H154;2;139;186306661;193999697;7693036
Jacobs;H154;2;49;199432096;202249334;2817238
Jacobs;H154;2;33;215098553;217925961;2827408
Jacobs;H154;2;17;219847222;220955491;1108269
Jacobs;H154;2;19;239510065;240647987;1137922
Jacobs;H154;10;18;12956525;13855191;898666
Jacobs;H154;10;84;16216118;20982790;4766672
Jacobs;H154;10;32;21682188;23289566;1607378
Jacobs;H154;10;68;25827394;29502667;3675273
Jacobs;H154;10;34;41802553;44519802;2717249
Jacobs;H154;10;38;48323497;50071084;1747587
Jacobs;H154;10;18;67493967;68694545;1200578
Jacobs;H154;10;23;83964085;85263429;1299344
Jacobs;H154;24;19;15865169;17307132;1441963
Jacobs;H154;24;68;26493858;31556086;5062228
Jacobs;H155;2;70;1606489;4835268;3228779
Jacobs;H155;2;27;25481746;27218367;1736621
Jacobs;H155;2;16;52327990;53043790;715800
Jacobs;H155;2;19;53986551;54687816;701265
Jacobs;H155;2;97;58791324;63837976;5046652
Jacobs;H155;2;221;65876876;78426196;12549320
Jacobs;H155;2;15;81452694;82013700;561006
Jacobs;H155;2;16;101134453;101709271;574818
Jacobs;H155;2;21;121796989;123494681;1697692
Jacobs;H155;2;58;127306102;130606432;3300330
Jacobs;H155;2;16;130818423;131682707;864284
Jacobs;H155;2;40;162492078;164594319;2102241
Jacobs;H155;2;17;171889296;172616581;727285
Jacobs;H155;2;37;179348624;182039142;2690518
Jacobs;H155;2;16;190574847;191319781;744934
Jacobs;H155;2;46;208020229;210557713;2537484
Jacobs;H155;2;18;215443702;217457102;2013400
Jacobs;H155;2;31;217719922;220103004;2383082
Jacobs;H155;2;16;231543005;232414241;871236
Jacobs;H155;2;16;232591652;233623788;1032136
Jacobs;H155;2;31;241649475;243449101;1799626
Jacobs;H155;2;26;246116878;247245173;1128295
Jacobs;H155;10;15;6551668;8114054;1562386
Jacobs;H155;10;27;16196817;17481523;1284706
Jacobs;H155;10;32;21682188;23289566;1607378
Jacobs;H155;10;68;25827394;29502667;3675273
Jacobs;H155;10;34;41802553;44519802;2717249
Jacobs;H155;10;38;48323497;50071084;1747587
Jacobs;H155;10;18;67493967;68694545;1200578
Jacobs;H155;24;19;15865169;17307132;1441963
Jacobs;H155;24;35;26493858;29197813;2703955
Jacobs;H156;2;26;15568475;16975392;1406917
Jacobs;H156;2;15;19666564;20379763;713199
Jacobs;H156;2;126;24646366;32300993;7654627
Jacobs;H156;2;27;40468426;42499181;2030755
Jacobs;H156;2;26;54135888;55425163;1289275
Jacobs;H156;2;181;65876876;76732322;10855446
Jacobs;H156;2;16;79000514;80032995;1032481
Jacobs;H156;2;23;122001925;123573014;1571089
Jacobs;H156;2;17;129537914;130606432;1068518
Jacobs;H156;2;31;162689295;164308657;1619362
Jacobs;H156;2;43;186306661;188826201;2519540
Jacobs;H156;2;23;192231314;193374050;1142736
Jacobs;H156;2;86;202088645;206427786;4339141
Jacobs;H156;2;97;207575434;212806608;5231174
Jacobs;H156;2;54;213505877;218592494;5086617
Jacobs;H156;2;41;219357404;221711968;2354564
Jacobs;H156;2;112;223876023;229880901;6004878
Jacobs;H156;2;16;231543005;232414241;871236
Jacobs;H156;2;16;232591652;233623788;1032136
Jacobs;H156;2;31;238831242;240477448;1646206
Jacobs;H156;10;18;2329436;3275097;945661
Jacobs;H156;10;16;6883264;8495362;1612098
Jacobs;H156;10;19;24977576;25943893;966317
Jacobs;H156;10;15;33986642;34603291;616649
Jacobs;H156;10;35;36637311;39489315;2852004
Jacobs;H156;10;71;46618259;49993899;3375640
Jacobs;H156;10;58;50743024;53477980;2734956
Jacobs;H156;10;66;58143024;62065368;3922344
Jacobs;H156;10;82;63706057;68597311;4891254
Jacobs;H156;10;201;71470411;82160471;10690060
Jacobs;H156;24;15;7615311;8339627;724316
Jacobs;H157;2;18;43340923;44256688;915765
Jacobs;H157;2;40;63387842;65163534;1775692
Jacobs;H157;2;28;65402955;67012655;1609700
Jacobs;H157;2;37;67534697;69441272;1906575
Jacobs;H157;2;19;70664942;71739429;1074487
Jacobs;H157;2;15;73109758;73839087;729329
Jacobs;H157;2;31;93251002;94768669;1517667
Jacobs;H157;2;17;103407822;104281644;873822
Jacobs;H157;2;23;122001925;123573014;1571089
Jacobs;H157;2;20;129421996;130606432;1184436
Jacobs;H157;2;41;147821995;149768329;1946334
Jacobs;H157;2;31;162689295;164308657;1619362
Jacobs;H157;2;34;204702992;206427786;1724794
Jacobs;H157;2;97;207575434;212806608;5231174
Jacobs;H157;2;37;213505877;217457102;3951225
Jacobs;H157;2;19;218058406;219468105;1409699
Jacobs;H157;2;17;219847222;220955491;1108269
Jacobs;H157;2;116;224213503;230439460;6225957
Jacobs;H157;10;16;6883264;8495362;1612098
Jacobs;H157;10;19;24977576;25943893;966317
Jacobs;H157;10;15;33986642;34603291;616649
Jacobs;H157;10;35;36637311;39489315;2852004
Jacobs;H157;10;71;46618259;49993899;3375640
Jacobs;H157;10;58;50743024;53477980;2734956
Jacobs;H157;10;17;58143024;59691651;1548627
Jacobs;H157;10;18;67493967;68694545;1200578
Jacobs;H157;10;119;71470411;78140084;6669673
Jacobs;H157;24;15;31899729;32598869;699140
Jacobs;H157;24;65;33798780;38916880;5118100
Jacobs;H158;2;70;1606489;4835268;3228779
Jacobs;H158;2;82;24756265;30051860;5295595
Jacobs;H158;2;16;36871168;38183817;1312649
Jacobs;H158;2;109;50949347;56751008;5801661
Jacobs;H158;2;31;57823523;59340110;1516587
Jacobs;H158;2;202;88900607;101388496;12487889
Jacobs;H158;2;32;108072803;109829764;1756961
Jacobs;H158;2;21;121796989;123494681;1697692
Jacobs;H158;2;58;127306102;130606432;3300330
Jacobs;H158;2;53;131596312;134094336;2498024
Jacobs;H158;2;38;140044111;141971484;1927373
Jacobs;H158;2;94;162689295;167736523;5047228
Jacobs;H158;2;605;170087722;205949338;35861616
Jacobs;H158;2;113;208020229;215098553;7078324
Jacobs;H158;2;18;215443702;217457102;2013400
Jacobs;H158;2;26;219847222;221354646;1507424
Jacobs;H158;2;29;226196223;227781732;1585509
Jacobs;H158;2;75;230505362;235032427;4527065
Jacobs;H158;2;37;236470812;238899861;2429049
Jacobs;H158;2;18;243302892;244622796;1319904
Jacobs;H158;10;15;6551668;8114054;1562386
Jacobs;H158;10;27;16196817;17481523;1284706
Jacobs;H158;10;32;21682188;23289566;1607378
Jacobs;H158;10;68;25827394;29502667;3675273
Jacobs;H158;10;18;36448017;37738237;1290220
Jacobs;H158;10;20;38727795;40071898;1344103
Jacobs;H158;10;40;48323497;50290499;1967002
Jacobs;H158;10;38;52101841;54375509;2273668
Jacobs;H158;10;44;56906392;59813838;2907446
Jacobs;H158;10;20;68271380;69311273;1039893
Jacobs;H158;10;42;74924462;77011574;2087112
Jacobs;H158;24;20;2043961;3507572;1463611
Jacobs;H158;24;15;22486632;23689555;1202923
Jacobs;H158;24;49;34460565;38459023;3998458
Jacobs;H158;24;23;39726323;41600515;1874192
Jacobs;H159;2;15;24966147;25765503;799356
Jacobs;H159;2;498;26520393;56751008;30230615
Jacobs;H159;2;202;88900607;101388496;12487889
Jacobs;H159;2;29;108264568;109829764;1565196
Jacobs;H159;2;21;121796989;123494681;1697692
Jacobs;H159;2;53;131596312;134094336;2498024
Jacobs;H159;2;38;140044111;141971484;1927373
Jacobs;H159;2;28;170856163;172424726;1568563
Jacobs;H159;2;74;181751292;186224877;4473585
Jacobs;H159;2;17;198875303;199681176;805873
Jacobs;H159;2;113;208020229;215098553;7078324
Jacobs;H159;2;16;215443702;216807667;1363965
Jacobs;H159;2;24;233775867;235184763;1408896
Jacobs;H159;2;18;239564082;240647987;1083905
Jacobs;H159;10;15;6551668;8114054;1562386
Jacobs;H159;10;16;17481523;18389301;907778
Jacobs;H159;10;15;33986642;34603291;616649
Jacobs;H159;10;35;36637311;39489315;2852004
Jacobs;H159;10;23;52768972;54375509;1606537
Jacobs;H159;10;35;71470411;73883116;2412705
Jacobs;H159;10;23;83964085;85263429;1299344
Jacobs;H159;24;15;22486632;23689555;1202923
Jacobs;H160;2;333;158066;18555382;18397316
Jacobs;H160;2;157;51529698;59340110;7810412
Jacobs;H160;2;26;72044787;73475221;1430434
Jacobs;H160;2;18;91996530;93217367;1220837
Jacobs;H160;2;17;103466624;104364614;897990
Jacobs;H160;2;30;121607287;123644129;2036842
Jacobs;H160;2;119;135996954;142593638;6596684
Jacobs;H160;2;27;143232237;144672338;1440101
Jacobs;H160;2;71;150948753;155337073;4388320
Jacobs;H160;2;25;162492078;163845372;1353294
Jacobs;H160;2;18;165399749;166276060;876311
Jacobs;H160;2;141;172699752;182097199;9397447
Jacobs;H160;2;70;187856073;191673164;3817091
Jacobs;H160;2;21;193151043;194324700;1173657
Jacobs;H160;2;41;215844761;220103004;4258243
Jacobs;H160;2;99;233461442;238899861;5438419
Jacobs;H160;2;21;246478010;247498052;1020042
Jacobs;H160;10;31;20540068;22285343;1745275
Jacobs;H160;10;113;23262240;29415140;6152900
Jacobs;H160;10;284;31493771;48972916;17479145
Jacobs;H160;10;36;53303637;55726976;2423339
Jacobs;H160;10;69;57089480;61237051;4147571
Jacobs;H160;10;36;68271380;70162514;1891134
Jacobs;H160;10;15;76428043;77101531;673488
Jacobs;H160;10;17;78238799;79062231;823432
Jacobs;H160;24;16;15865169;17159602;1294433
Jacobs;H160;24;16;26493858;27928201;1434343
Jacobs;H161;2;142;158066;8127552;7969486
Jacobs;H161;2;20;31641648;32674404;1032756
Jacobs;H161;2;44;40099347;43184130;3084783
Jacobs;H161;2;188;46045582;56751008;10705426
Jacobs;H161;2;26;72044787;73475221;1430434
Jacobs;H161;2;18;91996530;93217367;1220837
Jacobs;H161;2;30;121607287;123644129;2036842
Jacobs;H161;2;119;135996954;142593638;6596684
Jacobs;H161;2;19;142963793;144088879;1125086
Jacobs;H161;2;38;145628424;147996276;2367852
Jacobs;H161;2;143;149720801;158192547;8471746
Jacobs;H161;2;57;159389044;162464392;3075348
Jacobs;H161;2;24;169929278;171362036;1432758
Jacobs;H161;2;16;190574847;191319781;744934
Jacobs;H161;2;41;215844761;220103004;4258243
Jacobs;H161;2;36;225783164;227781732;1998568
Jacobs;H161;2;15;236541718;237613535;1071817
Jacobs;H161;10;226;20540068;32637918;12097850
Jacobs;H161;10;29;36883392;39489315;2605923
Jacobs;H161;10;18;40149974;40971187;821213
Jacobs;H161;10;37;47228374;48972916;1744542
Jacobs;H161;10;44;80519356;82687218;2167862
Jacobs;H161;24;16;203039;1377045;1174006
Jacobs;H161;24;44;11076801;14492312;3415511
Jacobs;H162;2;15;25243715;26263538;1019823
Jacobs;H162;2;22;40839676;42276176;1436500
Jacobs;H162;2;18;49220327;49993837;773510
Jacobs;H162;2;23;53528684;54596587;1067903
Jacobs;H162;2;112;69626926;76464705;6837779
Jacobs;H162;2;40;82290592;84891847;2601255
Jacobs;H162;2;21;121796989;123494681;1697692
Jacobs;H162;2;24;140442104;141557795;1115691
Jacobs;H162;2;34;162492078;164308657;1816579
Jacobs;H162;2;24;169929278;171362036;1432758
Jacobs;H162;2;50;172536035;175418941;2882906
Jacobs;H162;2;15;190055596;190786458;730862
Jacobs;H162;2;21;198116050;199020889;904839
Jacobs;H162;2;27;205305554;206886750;1581196
Jacobs;H162;2;44;210418618;212806608;2387990
Jacobs;H162;2;21;219357404;220852308;1494904
Jacobs;H162;2;16;223012717;223762044;749327
Jacobs;H162;2;252;231069887;245737846;14667959
Jacobs;H162;10;16;12376514;13428227;1051713
Jacobs;H162;10;23;18389301;19700851;1311550
Jacobs;H162;10;46;30072709;32465060;2392351
Jacobs;H162;10;18;36448017;37738237;1290220
Jacobs;H162;10;34;41802553;44519802;2717249
Jacobs;H162;10;25;48323497;49344061;1020564
Jacobs;H162;10;17;76428043;77210348;782305
Jacobs;H162;10;17;80865534;81641596;776062
Jacobs;H162;24;21;8489860;9658771;1168911
Jacobs;H162;24;26;16573702;18272045;1698343
Jacobs;H163;2;30;3812405;5179079;1366674
Jacobs;H163;2;18;10323184;11050939;727755
Jacobs;H163;2;111;16374818;22022061;5647243
Jacobs;H163;2;29;22784701;24157644;1372943
Jacobs;H163;2;20;24756265;25765503;1009238
Jacobs;H163;2;383;27311358;51384849;24073491
Jacobs;H163;2;43;93383608;95502833;2119225
Jacobs;H163;2;590;106181469;140468415;34286946
Jacobs;H163;2;24;141604180;142963793;1359613
Jacobs;H163;2;44;147210213;149666645;2456432
Jacobs;H163;2;18;157462596;158558328;1095732
Jacobs;H163;2;418;181751292;205572258;23820966
Jacobs;H163;2;36;215098553;218095888;2997335
Jacobs;H163;2;16;220780799;221413661;632862
Jacobs;H163;2;35;238831242;240721994;1890752
Jacobs;H163;10;17;7016861;8588571;1571710
Jacobs;H163;10;33;17481523;19399049;1917526
Jacobs;H163;10;27;21584008;22997802;1413794
Jacobs;H163;10;202;34386151;47487991;13101840
Jacobs;H163;10;40;47662790;49344061;1681271
Jacobs;H163;10;134;57335879;66177646;8841767
Jacobs;H163;10;17;67493967;68597311;1103344
Jacobs;H163;10;34;72713651;74308075;1594424
Jacobs;H163;10;59;78378416;81397746;3019330
Jacobs;H163;10;44;82994149;85263429;2269280
Jacobs;H163;24;15;34460565;35991517;1530952
Jacobs;H164;2;45;3104266;5215635;2111369
Jacobs;H164;2;31;6149666;7973431;1823765
Jacobs;H164;2;15;24966147;25765503;799356
Jacobs;H164;2;51;26520393;30051860;3531467
Jacobs;H164;2;16;36871168;38183817;1312649
Jacobs;H164;2;124;50949347;57495366;6546019
Jacobs;H164;2;130;67428296;75042274;7613978
Jacobs;H164;2;130;77200457;83899783;6699326
Jacobs;H164;2;17;110875234;112943535;2068301
Jacobs;H164;2;22;114411448;115784285;1372837
Jacobs;H164;2;17;115912934;117115355;1202421
Jacobs;H164;2;153;119388364;127390949;8002585
Jacobs;H164;2;18;134667278;135474064;806786
Jacobs;H164;2;16;148986290;149553962;567672
Jacobs;H164;2;17;169494537;170602376;1107839
Jacobs;H164;2;28;170856163;172424726;1568563
Jacobs;H164;2;221;203303306;216807667;13504361
Jacobs;H164;2;16;239679240;240684120;1004880
Jacobs;H164;2;21;246487220;247548978;1061758
Jacobs;H164;10;59;17860710;21386441;3525731
Jacobs;H164;10;72;25656485;29502667;3846182
Jacobs;H164;10;34;32818994;34536188;1717194
Jacobs;H164;10;16;36637311;37738237;1100926
Jacobs;H164;10;34;41802553;44519802;2717249
Jacobs;H164;10;39;50743024;52419746;1676722
Jacobs;H164;10;33;52768972;54955412;2186440
Jacobs;H164;10;24;56240111;57534184;1294073
Jacobs;H164;10;25;63706057;65354102;1648045
Jacobs;H164;10;60;71470411;75018763;3548352
Jacobs;H164;10;20;79188465;80204165;1015700
Jacobs;H164;24;21;15762894;17307132;1544238
Jacobs;H164;24;25;19819848;21878624;2058776
Jacobs;H165;2;1493;33980393;121653170;87672777
Jacobs;H165;2;18;122301320;123573014;1271694
Jacobs;H165;2;186;131397735;141439586;10041851
Jacobs;H165;2;86;142709866;147996276;5286410
Jacobs;H165;2;19;150948753;152160860;1212107
Jacobs;H165;2;167;154723424;164308657;9585233
Jacobs;H165;2;221;203303306;216807667;13504361
Jacobs;H165;2;36;225783164;227781732;1998568
Jacobs;H165;2;75;230505362;235032427;4527065
Jacobs;H165;2;37;236470812;238899861;2429049
Jacobs;H165;2;18;243302892;244622796;1319904
Jacobs;H165;10;66;10922307;14856146;3933839
Jacobs;H165;10;23;21126901;22376804;1249903
Jacobs;H165;10;16;25034802;25827394;792592
Jacobs;H165;10;15;26736937;27365899;628962
Jacobs;H165;10;18;31493771;32637918;1144147
Jacobs;H165;10;146;35566480;45845544;10279064
Jacobs;H165;10;26;55319894;56946876;1626982
Jacobs;H165;10;164;60005994;70162514;10156520
Jacobs;H165;10;127;71470411;78520137;7049726
Jacobs;H165;24;15;15865169;17133716;1268547
