group;id;chrom;nSNP;from;to;lengthBps
Jacobs;H70;2;24;7011767;8561759;1549992
Jacobs;H70;2;20;15581003;16743751;1162748
Jacobs;H70;2;48;67387676;69922573;2534897
Jacobs;H70;2;30;82692589;84640849;1948260
Jacobs;H70;2;18;93383608;94299450;915842
Jacobs;H70;2;53;103331488;106830369;3498881
Jacobs;H70;2;20;122060498;123528595;1468097
Jacobs;H70;2;24;136745970;138081646;1335676
Jacobs;H70;2;33;142863809;144672338;1808529
Jacobs;H70;2;15;156678409;157367793;689384
Jacobs;H70;2;46;167432552;169929278;2496726
Jacobs;H70;2;19;184760567;186136333;1375766
Jacobs;H70;2;47;186925871;189708780;2782909
Jacobs;H70;2;196;196397256;206974495;10577239
Jacobs;H70;2;249;207747048;223812677;16065629
Jacobs;H70;10;22;29842383;30849548;1007165
Jacobs;H70;10;201;32773769;45845544;13071775
Jacobs;H70;10;38;48397749;50290499;1892750
Jacobs;H70;10;33;52284660;54216568;1931908
Jacobs;H70;10;29;81117863;82508957;1391094
Jacobs;H70;24;30;16351007;18669354;2318347
Jacobs;H70;24;96;29375887;35991517;6615630
Jacobs;H71;2;41;14914968;17033754;2118786
Jacobs;H71;2;29;26100485;27784609;1684124
Jacobs;H71;2;243;42535118;56446750;13911632
Jacobs;H71;2;72;67387676;71671999;4284323
Jacobs;H71;2;33;72057797;73926990;1869193
Jacobs;H71;2;18;75042274;76075819;1033545
Jacobs;H71;2;30;79298450;80904183;1605733
Jacobs;H71;2;24;89818428;91333600;1515172
Jacobs;H71;2;15;94981400;95731895;750495
Jacobs;H71;2;26;121239876;123048197;1808321
Jacobs;H71;2;48;162689295;165169157;2479862
Jacobs;H71;2;15;168799360;169494537;695177
Jacobs;H71;2;51;183793517;187104069;3310552
Jacobs;H71;2;100;193433380;199432096;5998716
Jacobs;H71;2;48;211611196;215251657;3640461
Jacobs;H71;2;52;215844761;220852308;5007547
Jacobs;H71;2;21;229423565;230692645;1269080
Jacobs;H71;2;48;230789586;233589543;2799957
Jacobs;H71;2;16;233988816;234947844;959028
Jacobs;H71;2;56;237261566;240477448;3215882
Jacobs;H71;2;102;241371128;247245173;5874045
Jacobs;H71;10;47;14856146;17388048;2531902
Jacobs;H71;10;19;23068659;24187107;1118448
Jacobs;H71;10;98;25943893;30993691;5049798
Jacobs;H71;10;18;36448017;37738237;1290220
Jacobs;H71;10;20;38727795;40071898;1344103
Jacobs;H71;10;19;46618259;47513384;895125
Jacobs;H71;10;16;52284660;53098812;814152
Jacobs;H71;10;29;64870917;66447438;1576521
Jacobs;H71;10;74;78641554;82225985;3584431
Jacobs;H71;24;18;5384735;6265369;880634
Jacobs;H71;24;29;11127323;13558686;2431363
Jacobs;H71;24;44;17996334;21629724;3633390
Jacobs;H71;24;46;29475441;32495625;3020184
Jacobs;H71;24;50;37808477;41295400;3486923
Jacobs;H72;2;17;26853708;27784609;930901
Jacobs;H72;2;31;34011044;35582012;1570968
Jacobs;H72;2;33;51824098;53415584;1591486
Jacobs;H72;2;16;53991275;54669270;677995
Jacobs;H72;2;40;54687816;56804497;2116681
Jacobs;H72;2;161;66079196;75745623;9666427
Jacobs;H72;2;17;75970858;76836434;865576
Jacobs;H72;2;20;76896048;77817637;921589
Jacobs;H72;2;49;77836297;80421373;2585076
Jacobs;H72;2;15;106521892;107171359;649467
Jacobs;H72;2;28;121590788;123528595;1937807
Jacobs;H72;2;34;133402369;135337045;1934676
Jacobs;H72;2;25;142863809;144379920;1516111
Jacobs;H72;2;15;205305554;206180550;874996
Jacobs;H72;2;18;211611196;212749665;1138469
Jacobs;H72;2;22;213790888;215641893;1851005
Jacobs;H72;2;71;230238912;234609188;4370276
Jacobs;H72;2;59;236285593;239775862;3490269
Jacobs;H72;10;46;12231314;14856146;2624832
Jacobs;H72;10;30;36353216;38751668;2398452
Jacobs;H72;10;21;53666062;54955412;1289350
Jacobs;H72;10;34;62065368;65269159;3203791
Jacobs;H72;10;21;67307992;68575459;1267467
Jacobs;H72;10;36;84620983;86415081;1794098
Jacobs;H72;24;16;6783196;7721963;938767
Jacobs;H72;24;60;33397677;37753985;4356308
Jacobs;H78;2;40;21789864;23727919;1938055
Jacobs;H78;2;17;26853708;27784609;930901
Jacobs;H78;2;243;42535118;56446750;13911632
Jacobs;H78;2;72;67387676;71671999;4284323
Jacobs;H78;2;63;72057797;75799552;3741755
Jacobs;H78;2;15;77688427;78221205;532778
Jacobs;H78;2;26;121239876;123048197;1808321
Jacobs;H78;2;52;149539226;152437856;2898630
Jacobs;H78;2;33;155650761;157367793;1717032
Jacobs;H78;2;21;163790869;164745318;954449
Jacobs;H78;2;231;165226892;178922457;13695565
Jacobs;H78;2;32;179799000;181909538;2110538
Jacobs;H78;2;101;187916592;193374050;5457458
Jacobs;H78;2;48;211611196;215251657;3640461
Jacobs;H78;2;35;215844761;219694019;3849258
Jacobs;H78;2;128;226477839;233589543;7111704
Jacobs;H78;2;59;236285593;239775862;3490269
Jacobs;H78;10;20;2277631;3333520;1055889
Jacobs;H78;10;38;5810305;8904686;3094381
Jacobs;H78;10;145;23213276;30849548;7636272
Jacobs;H78;10;22;37182784;39457465;2274681
Jacobs;H78;10;19;40105937;40971187;865250
Jacobs;H78;10;34;46618259;48243886;1625627
Jacobs;H78;10;41;53666062;56430010;2763948
Jacobs;H78;10;18;56914955;57868492;953537
Jacobs;H78;10;29;64870917;66447438;1576521
Jacobs;H78;10;74;78641554;82225985;3584431
Jacobs;H78;24;15;11127323;12335936;1208613
Jacobs;H78;24;18;16041579;17438055;1396476
Jacobs;H78;24;96;31943864;38615161;6671297
Jacobs;H78;24;17;40336394;42027686;1691292
Jacobs;H79;2;138;15581003;22860326;7279323
Jacobs;H79;2;19;72891678;74004954;1113276
Jacobs;H79;2;117;121330712;127699622;6368910
Jacobs;H79;2;15;156678409;157367793;689384
Jacobs;H79;2;25;180080977;181909538;1828561
Jacobs;H79;2;31;182286302;183830160;1543858
Jacobs;H79;2;26;209015882;210418618;1402736
Jacobs;H79;2;81;231557166;235917576;4360410
Jacobs;H79;2;23;238940445;240012290;1071845
Jacobs;H79;10;26;15046611;16581183;1534572
Jacobs;H79;10;44;18737350;21363789;2626439
Jacobs;H79;10;32;29353089;30849548;1496459
Jacobs;H79;10;32;30993691;32818994;1825303
Jacobs;H79;10;18;36448017;37738237;1290220
Jacobs;H79;10;20;38727795;40071898;1344103
Jacobs;H79;10;144;47287047;54955412;7668365
Jacobs;H79;10;22;56539784;57534184;994400
Jacobs;H79;10;19;65537146;66447438;910292
Jacobs;H79;10;64;66535573;70187303;3651730
Jacobs;H79;10;39;75314642;77210348;1895706
Jacobs;H79;10;24;85263429;86415081;1151652
Jacobs;H79;24;15;33798780;34666650;867870
Jacobs;H80;2;137;22396321;30708966;8312645
Jacobs;H80;2;40;54687816;56804497;2116681
Jacobs;H80;2;28;61982604;63447389;1464785
Jacobs;H80;2;30;79298450;80904183;1605733
Jacobs;H80;2;20;83214641;84530797;1316156
Jacobs;H80;2;51;84640849;87394092;2753243
Jacobs;H80;2;29;87478446;88789712;1311266
Jacobs;H80;2;25;88900607;91063757;2163150
Jacobs;H80;2;15;108736660;109420304;683644
Jacobs;H80;2;16;129602869;130636386;1033517
Jacobs;H80;2;20;135996954;137024724;1027770
Jacobs;H80;2;59;141007423;144379920;3372497
Jacobs;H80;2;100;158290735;164074984;5784249
Jacobs;H80;2;40;176369323;178922457;2553134
Jacobs;H80;2;82;179799000;184673171;4874171
Jacobs;H80;2;48;211611196;215251657;3640461
Jacobs;H80;2;52;215844761;220852308;5007547
Jacobs;H80;2;224;229423565;242462366;13038801
Jacobs;H80;10;17;14007878;14856146;848268
Jacobs;H80;10;46;19637375;22285343;2647968
Jacobs;H80;10;360;25943893;47487991;21544098
Jacobs;H80;10;18;47662790;48397749;734959
Jacobs;H80;24;69;16041579;21629724;5588145
Jacobs;H86;2;30;5940814;7413337;1472523
Jacobs;H86;2;138;15581003;22860326;7279323
Jacobs;H86;2;59;118099428;121330712;3231284
Jacobs;H86;2;20;122060498;123528595;1468097
Jacobs;H86;2;38;125343919;127088467;1744548
Jacobs;H86;2;37;131397735;132967710;1569975
Jacobs;H86;2;144;162513140;170563260;8050120
Jacobs;H86;2;55;204702992;207802311;3099319
Jacobs;H86;2;15;231557166;232414241;857075
Jacobs;H86;2;16;233988816;234947844;959028
Jacobs;H86;2;45;237261566;239775862;2514296
Jacobs;H86;2;33;246838210;248799264;1961054
Jacobs;H86;10;15;7208458;8588571;1380113
Jacobs;H86;10;179;21682188;31152708;9470520
Jacobs;H86;10;18;36448017;37738237;1290220
Jacobs;H86;10;20;38727795;40071898;1344103
Jacobs;H86;10;48;49876303;52388827;2512524
Jacobs;H86;10;16;72510364;73316053;805689
Jacobs;H86;10;39;73780536;75564317;1783781
Jacobs;H86;10;67;82994149;86415081;3420932
Jacobs;H86;24;39;96467;3333012;3236545
Jacobs;H86;24;24;33056732;34176391;1119659
Jacobs;H87;2;95;17909542;22860326;4950784
Jacobs;H87;2;15;122301320;123494681;1193361
Jacobs;H87;2;26;138813572;139939771;1126199
Jacobs;H87;2;28;162689295;164188754;1499459
Jacobs;H87;2;120;186224877;192989350;6764473
Jacobs;H87;2;15;203751286;204502491;751205
Jacobs;H87;2;61;207575434;210816816;3241382
Jacobs;H87;2;46;212342465;215498705;3156240
Jacobs;H87;2;18;217719922;219015064;1295142
Jacobs;H87;10;121;1413129;10010195;8597066
Jacobs;H87;10;107;25228106;30849548;5621442
Jacobs;H87;10;32;30993691;32818994;1825303
Jacobs;H87;10;18;36448017;37738237;1290220
Jacobs;H87;10;20;38727795;40071898;1344103
Jacobs;H87;10;144;47287047;54955412;7668365
Jacobs;H87;10;22;56539784;57534184;994400
Jacobs;H87;24;30;31556086;33343694;1787608
Jacobs;H87;24;17;40336394;42027686;1691292
Jacobs;H88;2;26;4781740;6149666;1367926
Jacobs;H88;2;40;24966147;27311358;2345211
Jacobs;H88;2;49;54240741;56804497;2563756
Jacobs;H88;2;146;63814688;72147185;8332497
Jacobs;H88;2;24;87394092;88553200;1159108
Jacobs;H88;2;15;106975218;107573497;598279
Jacobs;H88;2;25;113113775;115340878;2227103
Jacobs;H88;2;28;121590788;123528595;1937807
Jacobs;H88;2;34;133402369;135337045;1934676
Jacobs;H88;2;20;135996954;137024724;1027770
Jacobs;H88;2;73;155650761;160096561;4445800
Jacobs;H88;2;75;160185941;164188754;4002813
Jacobs;H88;2;31;182286302;183830160;1543858
Jacobs;H88;2;102;187856073;193374050;5517977
Jacobs;H88;2;35;211611196;213674776;2063580
Jacobs;H88;2;22;213790888;215641893;1851005
Jacobs;H88;2;23;231170715;232414241;1243526
Jacobs;H88;10;52;1413129;4903158;3490029
Jacobs;H88;10;87;4986490;11027862;6041372
Jacobs;H88;10;36;18670320;20686326;2016006
Jacobs;H88;10;201;32773769;45845544;13071775
Jacobs;H88;10;155;48993276;57868492;8875216
Jacobs;H88;10;25;62729605;65269159;2539554
Jacobs;H88;10;41;75599218;77753126;2153908
Jacobs;H88;24;182;9352754;24060526;14707772
Jacobs;H88;24;130;24106007;33343694;9237687
Jacobs;H88;24;32;39300789;42027686;2726897
Jacobs;H93;2;26;158066;2157185;1999119
Jacobs;H93;2;50;2451471;4697573;2246102
Jacobs;H93;2;113;10887825;17033754;6145929
Jacobs;H93;2;35;22396321;24092677;1696356
Jacobs;H93;2;18;24839164;25709378;870214
Jacobs;H93;2;16;31657214;32379564;722350
Jacobs;H93;2;49;54240741;56804497;2563756
Jacobs;H93;2;28;65402955;67012655;1609700
Jacobs;H93;2;45;79017511;81273844;2256333
Jacobs;H93;2;69;103618164;107627876;4009712
Jacobs;H93;2;17;122060498;123432784;1372286
Jacobs;H93;2;56;130965527;133577022;2611495
Jacobs;H93;2;45;140158515;142506224;2347709
Jacobs;H93;2;15;145444039;146243868;799829
Jacobs;H93;2;19;149720801;150755823;1035022
Jacobs;H93;2;95;151148561;156827682;5679121
Jacobs;H93;2;49;168438851;171362036;2923185
Jacobs;H93;2;55;181645416;184760567;3115151
Jacobs;H93;2;61;185861913;189593772;3731859
Jacobs;H93;2;120;193433380;200791746;7358366
Jacobs;H93;2;115;206338485;212749665;6411180
Jacobs;H93;2;145;213505877;223908949;10403072
Jacobs;H93;2;112;231060457;237221424;6160967
Jacobs;H93;2;48;246210686;248799264;2588578
Jacobs;H93;10;56;17336717;20584964;3248247
Jacobs;H93;10;116;23709461;29882404;6172943
Jacobs;H93;10;201;32773769;45845544;13071775
Jacobs;H93;10;31;47287047;48696250;1409203
Jacobs;H93;10;21;67307992;68575459;1267467
Jacobs;H93;24;48;4276981;7107585;2830604
Jacobs;H93;24;72;11611963;16811910;5199947
Jacobs;H94;2;17;5039528;5798140;758612
Jacobs;H94;2;27;22809937;24092677;1282740
Jacobs;H94;2;18;24839164;25709378;870214
Jacobs;H94;2;16;31657214;32379564;722350
Jacobs;H94;2;16;39586061;40468426;882365
Jacobs;H94;2;57;63635636;66543498;2907862
Jacobs;H94;2;68;71178447;75042274;3863827
Jacobs;H94;2;60;88900607;93217367;4316760
Jacobs;H94;2;44;99302002;101521231;2219229
Jacobs;H94;2;22;116635922;117736662;1100740
Jacobs;H94;2;19;130606432;131649580;1043148
Jacobs;H94;2;16;134334411;135304995;970584
Jacobs;H94;2;75;135996954;140273577;4276623
Jacobs;H94;2;15;183721180;184507559;786379
Jacobs;H94;2;15;205305554;206180550;874996
Jacobs;H94;2;323;207369466;227380600;20011134
Jacobs;H94;10;18;12770970;13767913;996943
Jacobs;H94;10;32;14949320;16721856;1772536
Jacobs;H94;10;146;20584964;28538940;7953976
Jacobs;H94;10;39;47662790;49310196;1647406
Jacobs;H94;10;35;68339290;70187303;1848013
Jacobs;H94;10;103;71426400;77142109;5715709
Jacobs;H94;10;49;77718492;80133131;2414639
Jacobs;H94;24;15;9268996;10709974;1440978
Jacobs;H94;24;17;16041579;17307132;1265553
Jacobs;H94;24;15;18888717;20406106;1517389
Jacobs;H94;24;60;24591560;28877449;4285889
Jacobs;H95;2;44;14827510;17033754;2206244
Jacobs;H95;2;141;22396321;30849683;8453362
Jacobs;H95;2;33;51824098;53415584;1591486
Jacobs;H95;2;16;53991275;54669270;677995
Jacobs;H95;2;36;54687816;56556228;1868412
Jacobs;H95;2;113;63635636;69660591;6024955
Jacobs;H95;2;78;70802060;75507684;4705624
Jacobs;H95;2;81;84640849;88789712;4148863
Jacobs;H95;2;28;100753683;101985195;1231512
Jacobs;H95;2;19;122060498;123494681;1434183
Jacobs;H95;2;25;131165894;132323750;1157856
Jacobs;H95;2;72;156678409;161172554;4494145
Jacobs;H95;2;36;201514161;203129937;1615776
Jacobs;H95;2;33;203219228;204881765;1662537
Jacobs;H95;2;80;208232368;212749665;4517297
Jacobs;H95;2;98;231170715;236347543;5176828
Jacobs;H95;2;100;243005095;248799264;5794169
Jacobs;H95;10;41;7492074;10273523;2781449
Jacobs;H95;10;19;21309973;22285343;975370
Jacobs;H95;10;90;28071590;32637918;4566328
Jacobs;H95;10;18;36448017;37738237;1290220
Jacobs;H95;10;20;38727795;40071898;1344103
Jacobs;H95;10;212;41271768;53477980;12206212
Jacobs;H95;10;17;67307992;68311196;1003204
Jacobs;H95;10;82;82083004;86415081;4332077
Jacobs;H95;24;22;7721963;8842899;1120936
Jacobs;H95;24;31;18888717;21629724;2741007
Jacobs;H95;24;57;33740824;38125663;4384839
Jacobs;H95;24;15;39300789;40256403;955614
Jacobs;H96;2;172;17140743;26300198;9159455
Jacobs;H96;2;19;58791324;59762935;971611
Jacobs;H96;2;125;88900607;96717906;7817299
Jacobs;H96;2;20;122060498;123528595;1468097
Jacobs;H96;2;15;134667278;135391568;724290
Jacobs;H96;2;35;140158515;141971484;1812969
Jacobs;H96;2;63;145994402;149553962;3559560
Jacobs;H96;2;144;149666645;158192547;8525902
Jacobs;H96;2;28;162689295;164188754;1499459
Jacobs;H96;2;367;168220661;190937309;22716648
Jacobs;H96;2;160;191042331;200095669;9053338
Jacobs;H96;2;16;215498705;217457102;1958397
Jacobs;H96;2;23;219357404;220955491;1598087
Jacobs;H96;2;63;231170715;234947844;3777129
Jacobs;H96;10;176;21309973;30618253;9308280
Jacobs;H96;10;37;30674002;32637918;1963916
Jacobs;H96;10;28;36883392;39457465;2574073
Jacobs;H96;10;19;40105937;40971187;865250
Jacobs;H96;10;34;46618259;48243886;1625627
Jacobs;H96;10;23;52768972;54375509;1606537
Jacobs;H96;10;79;74111393;78140084;4028691
Jacobs;H96;10;37;82687218;84537988;1850770
Jacobs;H96;24;16;39711452;40762840;1051388
Jacobs;H101;2;72;158066;4309913;4151847
Jacobs;H101;2;111;7413337;13747683;6334346
Jacobs;H101;2;426;46833373;69880623;23047250
Jacobs;H101;2;27;93217367;94609125;1391758
Jacobs;H101;2;341;117612053;136166662;18554609
Jacobs;H101;2;30;142656135;144457580;1801445
Jacobs;H101;2;30;149539226;151200968;1661742
Jacobs;H101;2;70;152359296;156678409;4319113
Jacobs;H101;2;30;173375520;175247582;1872062
Jacobs;H101;2;55;181645416;184760567;3115151
Jacobs;H101;2;23;217890987;219694019;1803032
Jacobs;H101;2;15;220083076;220955491;872415
Jacobs;H101;2;16;221574841;222438632;863791
Jacobs;H101;10;114;4324626;11685764;7361138
Jacobs;H101;10;148;21927581;29882404;7954823
Jacobs;H101;10;34;36637311;39457465;2820154
Jacobs;H101;10;25;85162550;86415081;1252531
Jacobs;H101;24;65;96467;5384735;5288268
Jacobs;H101;24;298;17040364;39300789;22260425
Jacobs;H102;2;23;24966147;26300198;1334051
Jacobs;H102;2;149;45658202;54386685;8728483
Jacobs;H102;2;313;101320194;121330712;20010518
Jacobs;H102;2;20;122060498;123528595;1468097
Jacobs;H102;2;34;133402369;135337045;1934676
Jacobs;H102;2;102;158290735;164188754;5898019
Jacobs;H102;2;16;215498705;217457102;1958397
Jacobs;H102;2;16;239958619;240897051;938432
Jacobs;H102;10;90;5333921;11404177;6070256
Jacobs;H102;10;43;12339027;14856146;2517119
Jacobs;H102;10;238;30674002;45845544;15171542
Jacobs;H102;10;23;52768972;54375509;1606537
Jacobs;H102;10;16;67609179;68694545;1085366
Jacobs;H102;10;33;74111393;75682529;1571136
Jacobs;H102;10;21;77507372;78599973;1092601
Jacobs;H102;10;19;84696261;85627106;930845
Jacobs;H102;24;19;2043961;3446498;1402537
Jacobs;H102;24;37;6265369;8339627;2074258
Jacobs;H102;24;26;8842899;10977878;2134979
Jacobs;H102;24;37;33313461;35878194;2564733
Jacobs;H102;24;19;39603557;40762840;1159283
Jacobs;H103;2;25;11979482;13307050;1327568
Jacobs;H103;2;25;31353780;32674404;1320624
Jacobs;H103;2;35;46045582;48586900;2541318
Jacobs;H103;2;285;48649872;63479215;14829343
Jacobs;H103;2;45;67428296;69880623;2452327
Jacobs;H103;2;42;81746910;84368094;2621184
Jacobs;H103;2;37;84580673;86669812;2089139
Jacobs;H103;2;22;91063757;92132718;1068961
Jacobs;H103;2;27;93217367;94609125;1391758
Jacobs;H103;2;15;99623937;100697530;1073593
Jacobs;H103;2;94;121330712;126384559;5053847
Jacobs;H103;2;27;127495017;129045322;1550305
Jacobs;H103;2;44;131727936;133577022;1849086
Jacobs;H103;2;52;181909538;184760567;2851029
Jacobs;H103;2;63;203303306;206643029;3339723
Jacobs;H103;2;17;207575434;208358342;782908
Jacobs;H103;2;46;212342465;215498705;3156240
Jacobs;H103;2;19;218095888;219694019;1598131
Jacobs;H103;2;18;220083076;221078667;995591
Jacobs;H103;2;20;226617529;227734587;1117058
Jacobs;H103;2;124;230279194;237221424;6942230
Jacobs;H103;2;27;247079021;248799264;1720243
Jacobs;H103;10;41;5450092;8904686;3454594
Jacobs;H103;10;44;29842383;31770739;1928356
Jacobs;H103;10;34;36637311;39457465;2820154
Jacobs;H103;10;20;51804306;52630202;825896
Jacobs;H103;10;29;53098812;54955412;1856600
Jacobs;H103;10;35;57261965;59691651;2429686
Jacobs;H103;10;25;68944509;70187303;1242794
Jacobs;H103;10;17;71426400;72848051;1421651
Jacobs;H103;10;65;74681400;78093080;3411680
Jacobs;H103;10;54;78641554;81397746;2756192
Jacobs;H103;10;26;82994149;84137492;1143343
Jacobs;H103;10;34;84696261;86415081;1718820
Jacobs;H103;24;32;9352754;12335936;2983182
Jacobs;H103;24;26;39711452;42027686;2316234
Jacobs;H104;2;22;25007252;26300198;1292946
Jacobs;H104;2;195;45552152;56804497;11252345
Jacobs;H104;2;20;65402955;66543498;1140543
Jacobs;H104;2;149;79017511;87394092;8376581
Jacobs;H104;2;29;87478446;88789712;1311266
Jacobs;H104;2;15;122301320;123494681;1193361
Jacobs;H104;2;34;133402369;135337045;1934676
Jacobs;H104;2;69;140158515;143918492;3759977
Jacobs;H104;2;15;162383470;163109337;725867
Jacobs;H104;2;33;199777656;201797379;2019723
Jacobs;H104;2;15;205305554;206180550;874996
Jacobs;H104;2;139;209050239;219015064;9964825
Jacobs;H104;2;63;231170715;234947844;3777129
Jacobs;H104;2;32;236768061;238675170;1907109
Jacobs;H104;10;197;25228106;35596332;10368226
Jacobs;H104;10;17;35665391;36653024;987633
Jacobs;H104;10;28;36883392;39457465;2574073
Jacobs;H104;10;17;40105937;40749405;643468
Jacobs;H104;10;27;47662790;48804938;1142148
Jacobs;H104;10;189;49560674;60841810;11281136
Jacobs;H104;10;31;81397746;82888777;1491031
Jacobs;H104;24;19;2043961;3446498;1402537
Jacobs;H104;24;69;16351007;22222030;5871023
Jacobs;H108;2;28;8127552;9735180;1607628
Jacobs;H108;2;870;25243715;76075819;50832104
Jacobs;H108;2;155;76627899;84802665;8174766
Jacobs;H108;2;25;84938566;86380895;1442329
Jacobs;H108;2;20;107171359;107911874;740515
Jacobs;H108;2;16;108309773;108954373;644600
Jacobs;H108;2;17;122060498;123432784;1372286
Jacobs;H108;2;128;147821995;155158608;7336613
Jacobs;H108;2;24;196397256;197705689;1308433
Jacobs;H108;2;15;200749064;201496886;747822
Jacobs;H108;2;18;211611196;212749665;1138469
Jacobs;H108;2;67;213505877;219831281;6325404
Jacobs;H108;2;81;219933911;224139429;4205518
Jacobs;H108;2;15;245248045;246249900;1001855
Jacobs;H108;10;26;12231314;13767913;1536599
Jacobs;H108;10;73;25943893;29882404;3938511
Jacobs;H108;10;363;32773769;54216568;21442799
Jacobs;H108;10;21;67307992;68575459;1267467
Jacobs;H108;10;120;78641554;84741018;6099464
Jacobs;H108;24;72;11611963;16811910;5199947
Jacobs;H108;24;20;32598869;33692582;1093713
Jacobs;H109;2;17;5094572;5940814;846242
Jacobs;H109;2;141;22396321;30849683;8453362
Jacobs;H109;2;43;35582012;38602691;3020679
Jacobs;H109;2;16;53991275;54669270;677995
Jacobs;H109;2;74;84640849;88553200;3912351
Jacobs;H109;2;128;96566325;104101891;7535566
Jacobs;H109;2;117;118134501;124907852;6773351
Jacobs;H109;2;31;125343919;126734704;1390785
Jacobs;H109;2;19;130606432;131649580;1043148
Jacobs;H109;2;35;140158515;141971484;1812969
Jacobs;H109;2;17;167533866;168355070;821204
Jacobs;H109;2;33;199777656;201797379;2019723
Jacobs;H109;2;15;205305554;206180550;874996
Jacobs;H109;2;146;209050239;219694019;10643780
Jacobs;H109;2;89;231170715;235917576;4746861
Jacobs;H109;10;16;28502457;29353089;850632
Jacobs;H109;10;34;46618259;48243886;1625627
Jacobs;H109;10;49;58143024;61237051;3094027
Jacobs;H109;10;25;84100127;85541040;1440913
Jacobs;H109;24;87;11076801;17307132;6230331
Jacobs;H109;24;16;20395301;21554660;1159359
Jacobs;H110;2;20;2451471;3291115;839644
Jacobs;H110;2;129;7490500;14827510;7337010
Jacobs;H110;2;830;22396321;70126155;47729834
Jacobs;H110;2;38;72875158;75042274;2167116
Jacobs;H110;2;175;75674121;85150906;9476785
Jacobs;H110;2;17;89995144;91063757;1068613
Jacobs;H110;2;317;96439757;117158936;20719179
Jacobs;H110;2;148;119854666;127495017;7640351
Jacobs;H110;2;16;131727936;132323750;595814
Jacobs;H110;2;84;137832529;142506224;4673695
Jacobs;H110;2;334;145444039;164903825;19459786
Jacobs;H110;2;49;168438851;171362036;2923185
Jacobs;H110;2;55;181645416;184760567;3115151
Jacobs;H110;2;27;187856073;189593772;1737699
Jacobs;H110;2;32;194853812;197093416;2239604
Jacobs;H110;2;21;199432096;200791746;1359650
Jacobs;H110;2;18;211611196;212749665;1138469
Jacobs;H110;2;162;213505877;224825575;11319698
Jacobs;H110;2;42;236562748;239149511;2586763
Jacobs;H110;2;23;239655117;240967385;1312268
Jacobs;H110;10;48;12770970;15472049;2701079
Jacobs;H110;10;327;25943893;45845544;19901651
Jacobs;H110;10;31;47287047;48696250;1409203
Jacobs;H110;10;21;67307992;68575459;1267467
Jacobs;H110;10;16;84812819;85627106;814287
Jacobs;H110;24;71;96467;5726120;5629653
Jacobs;H110;24;403;11611963;42027686;30415723
Jacobs;H111;2;54;2451471;4835268;2383797
Jacobs;H111;2;124;10448019;17033754;6585735
Jacobs;H111;2;21;22396321;23366203;969882
Jacobs;H111;2;178;23487206;34303557;10816351
Jacobs;H111;2;29;53415584;54744188;1328604
Jacobs;H111;2;17;73046724;73926990;880266
Jacobs;H111;2;30;79298450;80904183;1605733
Jacobs;H111;2;203;84640849;96439757;11798908
Jacobs;H111;2;20;113897647;115476148;1578501
Jacobs;H111;2;21;121796989;123494681;1697692
Jacobs;H111;2;47;126298276;128843993;2545717
Jacobs;H111;2;38;141725733;143918492;2192759
Jacobs;H111;2;15;162383470;163109337;725867
Jacobs;H111;2;64;199777656;203129937;3352281
Jacobs;H111;2;33;203219228;204881765;1662537
Jacobs;H111;2;16;206643029;207609417;966388
Jacobs;H111;2;66;209050239;212749665;3699426
Jacobs;H111;2;22;219357404;220903491;1546087
Jacobs;H111;2;89;231170715;235917576;4746861
Jacobs;H111;10;37;21682188;23673666;1991478
Jacobs;H111;10;283;30072709;47487991;17415282
Jacobs;H111;10;20;74681400;75682529;1001129
Jacobs;H111;10;43;84100127;86415081;2314954
Jacobs;H111;24;17;96467;1377045;1280578
Jacobs;H111;24;25;25017904;27159621;2141717
Jacobs;H111;24;23;32354842;33643979;1289137
Jacobs;H111;24;19;39603557;40762840;1159283
Jacobs;H112;2;49;5039528;7490500;2450972
Jacobs;H112;2;23;8518359;9735180;1216821
Jacobs;H112;2;48;22396321;24861755;2465434
Jacobs;H112;2;92;24921180;30849683;5928503
Jacobs;H112;2;33;51824098;53415584;1591486
Jacobs;H112;2;16;53991275;54669270;677995
Jacobs;H112;2;44;54687816;56941505;2253689
Jacobs;H112;2;94;57009664;61735560;4725896
Jacobs;H112;2;141;62107494;69660591;7553097
Jacobs;H112;2;28;73475221;75042274;1567053
Jacobs;H112;2;101;84069275;90362958;6293683
Jacobs;H112;2;27;90945684;92162531;1216847
Jacobs;H112;2;16;98652142;99487592;835450
Jacobs;H112;2;20;113897647;115476148;1578501
Jacobs;H112;2;19;122060498;123494681;1434183
Jacobs;H112;2;16;133594324;134770618;1176294
Jacobs;H112;2;24;136745970;138081646;1335676
Jacobs;H112;2;45;141299872;143864562;2564690
Jacobs;H112;2;54;145398841;148711192;3312351
Jacobs;H112;2;110;148758742;155158608;6399866
Jacobs;H112;2;53;170058634;173151952;3093318
Jacobs;H112;2;25;175346551;177011834;1665283
Jacobs;H112;2;19;184760567;186136333;1375766
Jacobs;H112;2;43;189593772;191650061;2056289
Jacobs;H112;2;23;202088645;203129937;1041292
Jacobs;H112;2;36;203219228;205023204;1803976
Jacobs;H112;2;16;228130504;228848890;718386
Jacobs;H112;10;52;1413129;4903158;3490029
Jacobs;H112;10;73;4986490;10273523;5287033
Jacobs;H112;10;46;18402394;21273163;2870769
Jacobs;H112;10;126;25943893;32637918;6694025
Jacobs;H112;10;18;36448017;37738237;1290220
Jacobs;H112;10;20;38727795;40071898;1344103
Jacobs;H112;10;223;41271768;54216568;12944800
Jacobs;H112;10;35;57261965;59691651;2429686
Jacobs;H112;10;39;66062576;68311196;2248620
Jacobs;H112;10;32;78641554;80352577;1711023
Jacobs;H112;10;29;80386160;81739396;1353236
Jacobs;H112;10;89;81794966;86415081;4620115
Jacobs;H112;24;25;25017904;27159621;2141717
Jacobs;H117;2;38;2451471;4252497;1801026
Jacobs;H117;2;48;14523912;17033754;2509842
Jacobs;H117;2;16;53991275;54669270;677995
Jacobs;H117;2;19;58791324;59762935;971611
Jacobs;H117;2;66;85150906;88553200;3402294
Jacobs;H117;2;19;121796989;123432784;1635795
Jacobs;H117;2;162;126734704;135337045;8602341
Jacobs;H117;2;102;158290735;164188754;5898019
Jacobs;H117;2;59;215680487;220955491;5275004
Jacobs;H117;2;58;221773273;224687471;2914198
Jacobs;H117;2;85;244012987;248799264;4786277
Jacobs;H117;10;31;18930071;20584964;1654893
Jacobs;H117;10;37;30674002;32637918;1963916
Jacobs;H117;10;28;36883392;39457465;2574073
Jacobs;H117;10;19;40105937;40971187;865250
Jacobs;H117;10;34;46618259;48243886;1625627
Jacobs;H117;10;58;49310196;52388827;3078631
Jacobs;H117;24;94;6222497;12722014;6499517
Jacobs;H117;24;19;39603557;40762840;1159283
Jacobs;H65;2;22;4835268;6003251;1167983
Jacobs;H65;2;24;7011767;8561759;1549992
Jacobs;H65;2;15;42535118;43495949;960831
Jacobs;H65;2;132;43603937;51606428;8002491
Jacobs;H65;2;464;51777053;76829310;25052257
Jacobs;H65;2;139;76843058;84069275;7226217
Jacobs;H65;2;44;84279797;86907702;2627905
Jacobs;H65;2;44;86981313;88992392;2011079
Jacobs;H65;2;34;90731512;92511501;1779989
Jacobs;H65;2;163;92631842;102087094;9455252
Jacobs;H65;2;25;113113775;115340878;2227103
Jacobs;H65;2;104;122060498;127699622;5639124
Jacobs;H65;2;21;144603941;145745763;1141822
Jacobs;H65;2;20;155064316;155969590;905274
Jacobs;H65;2;18;186306661;187259707;953046
Jacobs;H65;2;37;187366378;189708780;2342402
Jacobs;H65;2;20;221216169;222080667;864498
Jacobs;H65;2;23;238940445;240012290;1071845
Jacobs;H65;10;89;1413129;7747456;6334327
Jacobs;H65;10;31;8404113;10010195;1606082
Jacobs;H65;10;103;25474389;30849548;5375159
Jacobs;H65;10;32;30993691;32818994;1825303
Jacobs;H65;10;18;36448017;37738237;1290220
Jacobs;H65;10;20;38727795;40071898;1344103
Jacobs;H65;10;69;47287047;50920778;3633731
Jacobs;H65;10;30;50995309;52272053;1276744
Jacobs;H65;10;177;52388827;63849945;11461118
Jacobs;H65;10;37;65354102;67307992;1953890
Jacobs;H65;24;66;31556086;35991517;4435431
Jacobs;H66;2;22;4835268;6003251;1167983
Jacobs;H66;2;134;8127552;15281005;7153453
Jacobs;H66;2;36;27355362;30026978;2671616
Jacobs;H66;2;38;52714676;54596587;1881911
Jacobs;H66;2;118;63635636;69922573;6286937
Jacobs;H66;2;34;70802060;72769457;1967397
Jacobs;H66;2;38;72875158;75042274;2167116
Jacobs;H66;2;26;84640849;86164251;1523402
Jacobs;H66;2;60;92631842;95965733;3333891
Jacobs;H66;2;19;122096448;123528595;1432147
Jacobs;H66;2;38;125343919;127088467;1744548
Jacobs;H66;2;26;127753578;129075107;1321529
Jacobs;H66;2;21;129124862;130206119;1081257
Jacobs;H66;2;15;130606432;131397735;791303
Jacobs;H66;2;16;142250151;143203167;953016
Jacobs;H66;2;25;143864562;145308492;1443930
Jacobs;H66;2;66;152895588;156827682;3932094
Jacobs;H66;2;17;188693526;189708780;1015254
Jacobs;H66;2;39;199432096;201797379;2365283
Jacobs;H66;2;15;205305554;206180550;874996
Jacobs;H66;2;18;211611196;212749665;1138469
Jacobs;H66;2;22;213790888;215641893;1851005
Jacobs;H66;10;26;12231314;13767913;1536599
Jacobs;H66;10;53;23709461;26736937;3027476
Jacobs;H66;10;24;26844939;27989538;1144599
Jacobs;H66;10;37;28071590;29882404;1810814
Jacobs;H66;10;18;53098812;54216568;1117756
Jacobs;H66;10;55;77718492;80465758;2747266
Jacobs;H66;10;40;80545891;82508957;1963066
Jacobs;H66;24;17;96467;1377045;1280578
Jacobs;H66;24;58;13558686;17307132;3748446
Jacobs;H67;2;21;26100485;27311358;1210873
Jacobs;H67;2;161;43014492;52702060;9687568
Jacobs;H67;2;49;54240741;56804497;2563756
Jacobs;H67;2;28;65402955;67012655;1609700
Jacobs;H67;2;17;70802060;71793127;991067
Jacobs;H67;2;47;76843058;79017511;2174453
Jacobs;H67;2;42;79183271;81273844;2090573
Jacobs;H67;2;26;96022899;97513382;1490483
Jacobs;H67;2;18;103143424;104101891;958467
Jacobs;H67;2;20;122060498;123528595;1468097
Jacobs;H67;2;22;138618372;139774896;1156524
Jacobs;H67;2;38;141007423;143089159;2081736
Jacobs;H67;2;42;149869064;152312317;2443253
Jacobs;H67;2;60;155064316;158321802;3257486
Jacobs;H67;2;40;158558328;161172554;2614226
Jacobs;H67;2;52;162689295;165399749;2710454
Jacobs;H67;2;30;173375520;175247582;1872062
Jacobs;H67;2;29;184760567;186705958;1945391
Jacobs;H67;2;23;186925871;188204145;1278274
Jacobs;H67;2;17;211695755;212749665;1053910
Jacobs;H67;2;22;213790888;215641893;1851005
Jacobs;H67;2;20;221216169;222080667;864498
Jacobs;H67;2;15;231557166;232414241;857075
Jacobs;H67;2;59;236285593;239775862;3490269
Jacobs;H67;10;17;13112312;14038808;926496
Jacobs;H67;10;35;14096224;16139981;2043757
Jacobs;H67;10;35;18670320;20584964;1914644
Jacobs;H67;10;30;23709461;25228106;1518645
Jacobs;H67;10;37;30674002;32637918;1963916
Jacobs;H67;10;15;36353216;37098832;745616
Jacobs;H67;10;17;57261965;58074623;812658
Jacobs;H67;10;17;58143024;59691651;1548627
Jacobs;H67;10;38;84494277;86415081;1920804
Jacobs;H67;24;16;6783196;7721963;938767
Jacobs;H67;24;17;40336394;42027686;1691292
Jacobs;H68;2;26;4781740;6149666;1367926
Jacobs;H68;2;27;22809937;24092677;1282740
Jacobs;H68;2;51;75799552;78221205;2421653
Jacobs;H68;2;16;78316809;79120023;803214
Jacobs;H68;2;80;79183271;83531972;4348701
Jacobs;H68;2;15;106975218;107573497;598279
Jacobs;H68;2;16;114224745;115340878;1116133
Jacobs;H68;2;28;121590788;123528595;1937807
Jacobs;H68;2;17;183793517;184760567;967050
Jacobs;H68;2;48;193176635;196397256;3220621
Jacobs;H68;2;15;205305554;206180550;874996
Jacobs;H68;2;20;209050239;210115127;1064888
Jacobs;H68;2;27;210244152;211539866;1295714
Jacobs;H68;2;17;211695755;212749665;1053910
Jacobs;H68;2;53;214005350;219015064;5009714
Jacobs;H68;2;33;223306849;224998163;1691314
Jacobs;H68;2;81;231557166;235917576;4360410
Jacobs;H68;10;26;17223259;18707689;1484430
Jacobs;H68;10;30;23709461;25228106;1518645
Jacobs;H68;10;28;25768345;27398550;1630205
Jacobs;H68;10;121;30674002;37098832;6424830
Jacobs;H68;10;31;37182784;40008673;2825889
Jacobs;H68;10;33;40105937;42021733;1915796
Jacobs;H68;10;24;46264587;47324609;1060022
Jacobs;H68;10;32;47487991;48960327;1472336
Jacobs;H68;10;33;48993276;50920778;1927502
Jacobs;H68;10;15;50995309;51646916;651607
Jacobs;H68;10;109;51707941;58074623;6366682
Jacobs;H68;10;19;58143024;59776861;1633837
Jacobs;H68;10;33;59887584;61391325;1503741
Jacobs;H68;10;19;61447380;62577331;1129951
Jacobs;H68;10;43;62729605;66144695;3415090
Jacobs;H68;10;29;66217820;67770351;1552531
Jacobs;H68;10;40;67954408;70187303;2232895
Jacobs;H68;24;32;39300789;42027686;2726897
Jacobs;H69;2;22;4835268;6003251;1167983
Jacobs;H69;2;24;7011767;8561759;1549992
Jacobs;H69;2;22;15581003;16805125;1224122
Jacobs;H69;2;26;21614658;22860326;1245668
Jacobs;H69;2;15;109007567;110083416;1075849
Jacobs;H69;2;28;121590788;123528595;1937807
Jacobs;H69;2;38;125343919;127088467;1744548
Jacobs;H69;2;70;164035357;167736523;3701166
Jacobs;H69;2;98;168438851;174083790;5644939
Jacobs;H69;2;15;174150382;175228526;1078144
Jacobs;H69;2;37;175305722;177720664;2414942
Jacobs;H69;2;31;187836750;189708780;1872030
Jacobs;H69;2;37;204702992;206643029;1940037
Jacobs;H69;2;81;208202599;212749665;4547066
Jacobs;H69;2;134;213790888;223460997;9670109
Jacobs;H69;2;29;227921207;229349932;1428725
Jacobs;H69;2;15;231557166;232414241;857075
Jacobs;H69;2;16;233988816;234947844;959028
Jacobs;H69;2;45;237261566;239775862;2514296
Jacobs;H69;2;33;246838210;248799264;1961054
Jacobs;H69;10;46;7492074;10531168;3039094
Jacobs;H69;10;107;25228106;30849548;5621442
Jacobs;H69;10;166;33603059;44519802;10916743
Jacobs;H69;10;15;44596003;45590208;994205
Jacobs;H69;10;48;49876303;52388827;2512524
Jacobs;H69;10;43;84100127;86415081;2314954
Jacobs;H69;24;71;96467;5726120;5629653
Jacobs;H69;24;28;39432711;41295400;1862689
Jacobs;H73;2;20;14837808;15802281;964473
Jacobs;H73;2;139;42535118;50813590;8278472
Jacobs;H73;2;118;63635636;69922573;6286937
Jacobs;H73;2;73;70802060;75042274;4240214
Jacobs;H73;2;20;80984252;81887124;902872
Jacobs;H73;2;26;84640849;86164251;1523402
Jacobs;H73;2;86;91143985;95965733;4821748
Jacobs;H73;2;20;122060498;123528595;1468097
Jacobs;H73;2;38;125343919;127088467;1744548
Jacobs;H73;2;50;127495017;130206119;2711102
Jacobs;H73;2;15;130606432;131397735;791303
Jacobs;H73;2;567;142250151;175228526;32978375
Jacobs;H73;2;534;175305722;206974495;31668773
Jacobs;H73;2;191;207747048;220955491;13208443
Jacobs;H73;2;88;222552458;227044476;4492018
Jacobs;H73;10;24;25943893;27365899;1422006
Jacobs;H73;10;20;29276560;30129111;852551
Jacobs;H73;10;20;36883392;38751668;1868276
Jacobs;H73;10;15;49560674;50632207;1071533
Jacobs;H73;10;22;56539784;57534184;994400
Jacobs;H73;10;132;79713068;86415081;6702013
Jacobs;H73;24;79;11682465;17307132;5624667
Jacobs;H74;2;48;158066;3104266;2946200
Jacobs;H74;2;22;6349125;7490500;1141375
Jacobs;H74;2;27;22809937;24092677;1282740
Jacobs;H74;2;18;24839164;25709378;870214
Jacobs;H74;2;65;54801135;57989729;3188594
Jacobs;H74;2;30;79298450;80904183;1605733
Jacobs;H74;2;93;84054194;89359755;5305561
Jacobs;H74;2;19;121796989;123432784;1635795
Jacobs;H74;2;27;142863809;144457580;1593771
Jacobs;H74;2;82;179799000;184673171;4874171
Jacobs;H74;2;176;197148559;206382108;9233549
Jacobs;H74;2;95;207575434;212749665;5174231
Jacobs;H74;2;45;237261566;239775862;2514296
Jacobs;H74;2;35;243490742;245737846;2247104
Jacobs;H74;10;29;29276560;30618253;1341693
Jacobs;H74;10;37;30674002;32637918;1963916
Jacobs;H74;10;28;36883392;39457465;2574073
Jacobs;H74;10;19;40105937;40971187;865250
Jacobs;H74;10;38;46618259;48397749;1779490
Jacobs;H74;10;65;49310196;52630202;3320006
Jacobs;H74;10;23;52768972;54375509;1606537
Jacobs;H74;10;43;84100127;86415081;2314954
Jacobs;H74;24;16;34607110;36160755;1553645
Jacobs;H75;2;22;4835268;6003251;1167983
Jacobs;H75;2;24;7011767;8561759;1549992
Jacobs;H75;2;26;21614658;22860326;1245668
Jacobs;H75;2;15;76515135;77170481;655346
Jacobs;H75;2;20;122060498;123528595;1468097
Jacobs;H75;2;38;125343919;127088467;1744548
Jacobs;H75;2;70;164035357;167736523;3701166
Jacobs;H75;2;47;167901271;170563260;2661989
Jacobs;H75;2;183;196397256;206180550;9783294
Jacobs;H75;2;25;209050239;210418618;1368379
Jacobs;H75;2;338;229248722;248799264;19550542
Jacobs;H75;10;36;7492074;10010195;2518121
Jacobs;H75;10;107;25228106;30849548;5621442
Jacobs;H75;10;32;30993691;32818994;1825303
Jacobs;H75;10;18;36448017;37738237;1290220
Jacobs;H75;10;20;38727795;40071898;1344103
Jacobs;H75;10;144;47287047;54955412;7668365
Jacobs;H75;10;22;56539784;57534184;994400
Jacobs;H75;10;38;66897110;69208998;2311888
Jacobs;H75;10;25;77276861;78641554;1364693
Jacobs;H75;24;39;96467;3333012;3236545
Jacobs;H75;24;19;27928201;29155367;1227166
Jacobs;H76;2;15;9940812;10537097;596285
Jacobs;H76;2;27;22809937;24092677;1282740
Jacobs;H76;2;29;126277306;127813744;1536438
Jacobs;H76;2;27;127910434;129196314;1285880
Jacobs;H76;2;67;131727936;135063522;3335586
Jacobs;H76;2;50;140655290;143493147;2837857
Jacobs;H76;2;104;162689295;168272499;5583204
Jacobs;H76;2;59;168355070;172042303;3687233
Jacobs;H76;2;30;173375520;175247582;1872062
Jacobs;H76;2;47;184760567;187836750;3076183
Jacobs;H76;2;31;204997139;206643029;1645890
Jacobs;H76;2;23;211695755;213129568;1433813
Jacobs;H76;2;23;213160521;215251657;2091136
Jacobs;H76;2;33;215844761;219404288;3559527
Jacobs;H76;2;18;219694019;220852308;1158289
Jacobs;H76;2;32;220955491;222552458;1596967
Jacobs;H76;2;29;238940445;240477448;1537003
Jacobs;H76;10;16;18707689;19534616;826927
Jacobs;H76;10;28;21682188;23126119;1443931
Jacobs;H76;10;16;30072709;30849548;776839
Jacobs;H76;10;29;30993691;32637918;1644227
Jacobs;H76;10;24;42113800;44171258;2057458
Jacobs;H76;10;22;48397749;49310196;912447
Jacobs;H76;10;42;53666062;56539784;2873722
Jacobs;H76;10;22;56914955;58074623;1159668
Jacobs;H76;10;17;58143024;59691651;1548627
Jacobs;H76;10;24;62795305;65269159;2473854
Jacobs;H76;24;23;7721963;8874963;1153000
Jacobs;H76;24;16;20838669;22222030;1383361
Jacobs;H76;24;17;40336394;42027686;1691292
Jacobs;H77;2;46;158066;2922962;2764896
Jacobs;H77;2;21;26100485;27311358;1210873
Jacobs;H77;2;204;35124377;48501546;13377169
Jacobs;H77;2;52;48586900;51384849;2797949
Jacobs;H77;2;81;52714676;56804497;4089821
Jacobs;H77;2;72;67387676;71671999;4284323
Jacobs;H77;2;16;75192672;76075819;883147
Jacobs;H77;2;18;79298450;80421373;1122923
Jacobs;H77;2;16;114224745;115340878;1116133
Jacobs;H77;2;103;122060498;127495017;5434519
Jacobs;H77;2;37;133164317;135337045;2172728
Jacobs;H77;2;50;140655290;143493147;2837857
Jacobs;H77;2;22;155650761;156827682;1176921
Jacobs;H77;2;18;186858300;187836750;978450
Jacobs;H77;2;113;206886750;213129568;6242818
Jacobs;H77;2;92;213160521;220955491;7794970
Jacobs;H77;2;28;222552458;223812677;1260219
Jacobs;H77;2;20;226617529;227734587;1117058
Jacobs;H77;2;59;236285593;239775862;3490269
Jacobs;H77;10;20;36883392;38751668;1868276
Jacobs;H77;10;15;41910764;42753634;842870
Jacobs;H77;10;29;53098812;54955412;1856600
Jacobs;H77;10;22;56539784;57534184;994400
Jacobs;H77;10;24;62795305;65269159;2473854
Jacobs;H77;10;36;84620983;86415081;1794098
Jacobs;H77;24;22;21878624;23689555;1810931
Jacobs;H77;24;32;39300789;42027686;2726897
Jacobs;H81;2;18;1038580;2157185;1118605
Jacobs;H81;2;42;2451471;4370486;1919015
Jacobs;H81;2;37;14837808;16743751;1905943
Jacobs;H81;2;195;35124377;48025916;12901539
Jacobs;H81;2;70;51143878;54766935;3623057
Jacobs;H81;2;48;67387676;69922573;2534897
Jacobs;H81;2;30;82692589;84640849;1948260
Jacobs;H81;2;83;86164251;91063757;4899506
Jacobs;H81;2;53;103331488;106830369;3498881
Jacobs;H81;2;22;122001925;123541288;1539363
Jacobs;H81;2;18;140104951;141007423;902472
Jacobs;H81;2;37;142250151;144457580;2207429
Jacobs;H81;2;88;202447133;206974495;4527362
Jacobs;H81;2;191;207747048;220955491;13208443
Jacobs;H81;2;88;222552458;227044476;4492018
Jacobs;H81;10;29;20584964;22285343;1700379
Jacobs;H81;10;24;25943893;27365899;1422006
Jacobs;H81;10;20;29276560;30129111;852551
Jacobs;H81;10;20;36883392;38751668;1868276
Jacobs;H81;10;15;49560674;50632207;1071533
Jacobs;H81;10;22;56539784;57534184;994400
Jacobs;H81;24;68;16351007;21910840;5559833
Jacobs;H81;24;31;29475441;31568788;2093347
Jacobs;H81;24;93;34345815;42027686;7681871
Jacobs;H82;2;40;21789864;23727919;1938055
Jacobs;H82;2;17;26853708;27784609;930901
Jacobs;H82;2;139;43014492;51384849;8370357
Jacobs;H82;2;63;54240741;57495366;3254625
Jacobs;H82;2;17;70802060;71793127;991067
Jacobs;H82;2;182;76627899;86380895;9752996
Jacobs;H82;2;55;94478102;97513382;3035280
Jacobs;H82;2;15;122301320;123494681;1193361
Jacobs;H82;2;85;131793590;136166662;4373072
Jacobs;H82;2;30;142656135;144457580;1801445
Jacobs;H82;2;89;152160860;157367793;5206933
Jacobs;H82;2;230;165259467;178922457;13662990
Jacobs;H82;2;32;179799000;181909538;2110538
Jacobs;H82;2;53;184760567;188204145;3443578
Jacobs;H82;2;48;211611196;215251657;3640461
Jacobs;H82;2;52;215844761;220852308;5007547
Jacobs;H82;2;29;230789586;232414241;1624655
Jacobs;H82;2;52;236768061;239775862;3007801
Jacobs;H82;2;24;242316517;243490742;1174225
Jacobs;H82;10;20;2277631;3333520;1055889
Jacobs;H82;10;56;4579327;8904686;4325359
Jacobs;H82;10;316;30674002;49560674;18886672
Jacobs;H82;10;28;52515784;54216568;1700784
Jacobs;H82;10;51;57261965;60578383;3316418
Jacobs;H82;10;21;64870917;66062576;1191659
Jacobs;H82;10;71;72270475;75746175;3475700
Jacobs;H82;24;49;6926756;9721533;2794777
Jacobs;H82;24;18;16041579;17438055;1396476
Jacobs;H82;24;96;31943864;38615161;6671297
Jacobs;H82;24;17;40336394;42027686;1691292
Jacobs;H83;2;23;16870828;18001962;1131134
Jacobs;H83;2;139;42535118;50813590;8278472
Jacobs;H83;2;15;77688427;78221205;532778
Jacobs;H83;2;100;80421373;86164251;5742878
Jacobs;H83;2;15;122301320;123494681;1193361
Jacobs;H83;2;31;127699622;129196314;1496692
Jacobs;H83;2;67;131727936;135063522;3335586
Jacobs;H83;2;21;144603941;145745763;1141822
Jacobs;H83;2;33;155064316;156827682;1763366
Jacobs;H83;2;56;186306661;189708780;3402119
Jacobs;H83;2;39;212342465;215251657;2909192
Jacobs;H83;2;64;215844761;221399780;5555019
Jacobs;H83;2;23;231170715;232414241;1243526
Jacobs;H83;2;23;239655117;240967385;1312268
Jacobs;H83;2;56;244165892;247079021;2913129
Jacobs;H83;10;17;13112312;14038808;926496
Jacobs;H83;10;35;14096224;16139981;2043757
Jacobs;H83;10;22;22454477;23604001;1149524
Jacobs;H83;10;107;25228106;30849548;5621442
Jacobs;H83;10;201;32773769;45845544;13071775
Jacobs;H83;10;155;48993276;57868492;8875216
Jacobs;H83;10;25;62729605;65269159;2539554
Jacobs;H83;10;35;75599218;77276861;1677643
Jacobs;H83;24;44;24989534;28424137;3434603
Jacobs;H83;24;17;40336394;42027686;1691292
Jacobs;H84;2;21;15568475;16743751;1175276
Jacobs;H84;2;23;21789864;22860326;1070462
Jacobs;H84;2;56;26853708;30708966;3855258
Jacobs;H84;2;255;35260588;51384849;16124261
Jacobs;H84;2;16;53991275;54669270;677995
Jacobs;H84;2;51;54801135;57495366;2694231
Jacobs;H84;2;30;79298450;80904183;1605733
Jacobs;H84;2;49;83457472;86380895;2923423
Jacobs;H84;2;15;94981400;95731895;750495
Jacobs;H84;2;22;122001925;123541288;1539363
Jacobs;H84;2;27;142863809;144457580;1593771
Jacobs;H84;2;17;165399749;166231789;832040
Jacobs;H84;2;25;175346551;177011834;1665283
Jacobs;H84;2;31;182286302;183830160;1543858
Jacobs;H84;2;46;191179157;193374050;2194893
Jacobs;H84;2;48;211611196;215251657;3640461
Jacobs;H84;2;52;215844761;220852308;5007547
Jacobs;H84;2;224;229423565;242462366;13038801
Jacobs;H84;10;15;8564410;9353873;789463
Jacobs;H84;10;17;14007878;14856146;848268
Jacobs;H84;10;46;19637375;22285343;2647968
Jacobs;H84;10;88;25943893;30618253;4674360
Jacobs;H84;10;37;30674002;32637918;1963916
Jacobs;H84;10;28;36883392;39457465;2574073
Jacobs;H84;10;19;40105937;40971187;865250
Jacobs;H84;10;18;46618259;47487991;869732
Jacobs;H84;10;39;47662790;49310196;1647406
Jacobs;H85;2;27;22809937;24092677;1282740
Jacobs;H85;2;26;56191129;57495366;1304237
Jacobs;H85;2;27;65596735;67168555;1571820
Jacobs;H85;2;42;149869064;152312317;2443253
Jacobs;H85;2;160;155064316;164188754;9124438
Jacobs;H85;2;70;167432552;171398254;3965702
Jacobs;H85;2;31;182286302;183830160;1543858
Jacobs;H85;2;102;187856073;193374050;5517977
Jacobs;H85;2;35;211611196;213674776;2063580
Jacobs;H85;2;22;213790888;215641893;1851005
Jacobs;H85;2;21;220083076;221216169;1133093
Jacobs;H85;2;53;226828226;229423565;2595339
Jacobs;H85;2;15;231557166;232414241;857075
Jacobs;H85;2;16;233988816;234947844;959028
Jacobs;H85;2;60;236221140;239775862;3554722
Jacobs;H85;10;20;2277631;3333520;1055889
Jacobs;H85;10;20;11898594;13153495;1254901
Jacobs;H85;10;101;14573661;20508567;5934906
Jacobs;H85;10;18;21682188;22650915;968727
Jacobs;H85;10;140;25228106;32637918;7409812
Jacobs;H85;10;28;36883392;39457465;2574073
Jacobs;H85;10;19;40105937;40971187;865250
Jacobs;H85;10;22;48397749;49310196;912447
Jacobs;H85;10;42;53666062;56539784;2873722
Jacobs;H85;10;40;56914955;59691651;2776696
Jacobs;H85;10;17;62065368;63849945;1784577
Jacobs;H85;10;59;72799573;75682529;2882956
Jacobs;H85;24;69;7721963;12722014;5000051
Jacobs;H89;2;440;2850561;26315932;23465371
Jacobs;H89;2;48;26664802;30026978;3362176
Jacobs;H89;2;34;35564869;37991496;2426627
Jacobs;H89;2;21;38155780;39416648;1260868
Jacobs;H89;2;32;51824098;53366034;1541936
Jacobs;H89;2;131;62820094;69880623;7060529
Jacobs;H89;2;19;121796989;123432784;1635795
Jacobs;H89;2;17;143847759;144672338;824579
Jacobs;H89;2;21;163790869;164745318;954449
Jacobs;H89;2;355;165226892;187104069;21877177
Jacobs;H89;2;100;193433380;199432096;5998716
Jacobs;H89;2;16;206643029;207609417;966388
Jacobs;H89;2;146;209050239;219694019;10643780
Jacobs;H89;2;18;220083076;221078667;995591
Jacobs;H89;2;361;223564458;243907649;20343191
Jacobs;H89;2;59;245349075;248799264;3450189
Jacobs;H89;10;62;4324626;8904686;4580060
Jacobs;H89;10;16;13056079;13855191;799112
Jacobs;H89;10;39;14573661;16744641;2170980
Jacobs;H89;10;15;17388048;18210142;822094
Jacobs;H89;10;18;20934075;21894024;959949
Jacobs;H89;10;18;36448017;37738237;1290220
Jacobs;H89;10;20;38727795;40071898;1344103
Jacobs;H89;10;18;46618259;47487991;869732
Jacobs;H89;10;54;50632207;53098812;2466605
Jacobs;H89;24;86;96467;6468168;6371701
Jacobs;H89;24;44;14492312;17307132;2814820
Jacobs;H89;24;71;17996334;24060526;6064192
Jacobs;H89;24;20;33313461;34176391;862930
Jacobs;H90;2;15;9940812;10537097;596285
Jacobs;H90;2;27;22809937;24092677;1282740
Jacobs;H90;2;26;121239876;123048197;1808321
Jacobs;H90;2;149;155650761;164188754;8537993
Jacobs;H90;2;29;183150772;184673171;1522399
Jacobs;H90;2;33;186224877;188204145;1979268
Jacobs;H90;2;39;212342465;215251657;2909192
Jacobs;H90;2;18;217719922;219015064;1295142
Jacobs;H90;2;32;220955491;222552458;1596967
Jacobs;H90;2;18;238940445;239775862;835417
Jacobs;H90;10;238;30674002;45845544;15171542
Jacobs;H90;10;38;48397749;50290499;1892750
Jacobs;H90;10;33;52284660;54216568;1931908
Jacobs;H90;10;30;56914955;59054630;2139675
Jacobs;H90;10;41;75599218;77753126;2153908
Jacobs;H90;24;16;6783196;7721963;938767
Jacobs;H90;24;18;16041579;17438055;1396476
Jacobs;H90;24;17;40336394;42027686;1691292
Jacobs;H91;2;65;985851;4309913;3324062
Jacobs;H91;2;21;4764715;5798140;1033425
Jacobs;H91;2;27;12418291;13747683;1329392
Jacobs;H91;2;100;17681852;22860326;5178474
Jacobs;H91;2;43;26100485;29305877;3205392
Jacobs;H91;2;16;31657214;32379564;722350
Jacobs;H91;2;32;51824098;53366034;1541936
Jacobs;H91;2;116;63635636;69880623;6244987
Jacobs;H91;2;85;77200457;81273844;4073387
Jacobs;H91;2;42;81746910;84368094;2621184
Jacobs;H91;2;17;122060498;123432784;1372286
Jacobs;H91;2;93;222552458;227238603;4686145
Jacobs;H91;2;44;237315458;239775862;2460404
Jacobs;H91;10;21;12339027;13579925;1240898
Jacobs;H91;10;39;17223259;19399049;2175790
Jacobs;H91;10;33;20482744;22285343;1802599
Jacobs;H91;10;17;29842383;30618253;775870
Jacobs;H91;10;26;30674002;31770739;1096737
Jacobs;H91;10;38;36883392;40071898;3188506
Jacobs;H91;10;116;40771431;48243886;7472455
Jacobs;H91;10;35;50876668;52388827;1512159
Jacobs;H91;10;19;55944722;56914955;970233
Jacobs;H91;10;43;58074623;60841810;2767187
Jacobs;H91;10;56;66966639;70187303;3220664
Jacobs;H91;10;56;71426400;74728587;3302187
Jacobs;H91;10;26;84029946;85541040;1511094
Jacobs;H91;24;18;6891468;7935697;1044229
Jacobs;H91;24;24;8842899;10709974;1867075
Jacobs;H91;24;21;11127323;12817574;1690251
Jacobs;H91;24;128;22377381;31943864;9566483
Jacobs;H92;2;65;985851;4309913;3324062
Jacobs;H92;2;21;4764715;5798140;1033425
Jacobs;H92;2;27;12418291;13747683;1329392
Jacobs;H92;2;27;17681852;19038121;1356269
Jacobs;H92;2;72;19128677;22860326;3731649
Jacobs;H92;2;43;26100485;29305877;3205392
Jacobs;H92;2;16;31657214;32379564;722350
Jacobs;H92;2;32;51824098;53366034;1541936
Jacobs;H92;2;116;63635636;69880623;6244987
Jacobs;H92;2;85;77200457;81273844;4073387
Jacobs;H92;2;42;81746910;84368094;2621184
Jacobs;H92;2;17;122060498;123432784;1372286
Jacobs;H92;2;93;222552458;227238603;4686145
Jacobs;H92;2;44;237315458;239775862;2460404
Jacobs;H92;10;21;12339027;13579925;1240898
Jacobs;H92;10;39;17223259;19399049;2175790
Jacobs;H92;10;27;20743646;22285343;1541697
Jacobs;H92;10;17;29842383;30618253;775870
Jacobs;H92;10;26;30674002;31770739;1096737
Jacobs;H92;10;32;37182784;40071898;2889114
Jacobs;H92;10;41;40771431;44171258;3399827
Jacobs;H92;10;26;44430609;45877910;1447301
Jacobs;H92;10;42;46264587;48243886;1979299
Jacobs;H92;10;35;50876668;52388827;1512159
Jacobs;H92;10;19;55944722;56914955;970233
Jacobs;H92;10;41;58143024;60841810;2698786
Jacobs;H92;10;37;66966639;69245324;2278685
Jacobs;H92;10;18;69311273;70187303;876030
Jacobs;H92;10;56;71426400;74728587;3302187
Jacobs;H92;10;16;84029946;84898582;868636
Jacobs;H92;24;18;6891468;7935697;1044229
Jacobs;H92;24;24;8842899;10709974;1867075
Jacobs;H92;24;21;11127323;12817574;1690251
Jacobs;H92;24;128;22377381;31943864;9566483
Jacobs;H97;2;44;14827510;17033754;2206244
Jacobs;H97;2;27;22809937;24092677;1282740
Jacobs;H97;2;138;24839164;33270908;8431744
Jacobs;H97;2;103;34556260;40931803;6375543
Jacobs;H97;2;40;54687816;56804497;2116681
Jacobs;H97;2;28;65402955;67012655;1609700
Jacobs;H97;2;17;73046724;73926990;880266
Jacobs;H97;2;30;79298450;80904183;1605733
Jacobs;H97;2;222;84640849;97685376;13044527
Jacobs;H97;2;24;122060498;123671526;1611028
Jacobs;H97;2;23;128510347;129602869;1092522
Jacobs;H97;2;44;131727936;133577022;1849086
Jacobs;H97;2;68;141725733;145648041;3922308
Jacobs;H97;2;35;211611196;213674776;2063580
Jacobs;H97;2;169;227921207;237221424;9300217
Jacobs;H97;10;138;1413129;10875464;9462335
Jacobs;H97;10;29;14949320;16612393;1663073
Jacobs;H97;10;26;21584008;22955949;1371941
Jacobs;H97;10;121;23305210;29882404;6577194
Jacobs;H97;10;18;36448017;37738237;1290220
Jacobs;H97;10;20;38727795;40071898;1344103
Jacobs;H97;10;223;41271768;54216568;12944800
Jacobs;H97;10;30;56914955;59054630;2139675
Jacobs;H97;10;39;66062576;68311196;2248620
Jacobs;H98;2;15;1717596;2515692;798096
Jacobs;H98;2;75;17969084;21883834;3914750
Jacobs;H98;2;27;22809937;24092677;1282740
Jacobs;H98;2;18;24839164;25709378;870214
Jacobs;H98;2;16;31657214;32379564;722350
Jacobs;H98;2;44;39586061;42550059;2963998
Jacobs;H98;2;26;49646230;51384849;1738619
Jacobs;H98;2;68;53366034;56804497;3438463
Jacobs;H98;2;32;79225836;80904183;1678347
Jacobs;H98;2;222;84640849;97685376;13044527
Jacobs;H98;2;24;122060498;123671526;1611028
Jacobs;H98;2;23;133594324;135063522;1469198
Jacobs;H98;2;24;136745970;138081646;1335676
Jacobs;H98;2;18;142863809;143864562;1000753
Jacobs;H98;2;16;144931308;145745763;814455
Jacobs;H98;2;19;149720801;150755823;1035022
Jacobs;H98;2;66;151148561;155158608;4010047
Jacobs;H98;2;30;186410235;188204145;1793910
Jacobs;H98;2;59;202088645;204997139;2908494
Jacobs;H98;2;80;208232368;212749665;4517297
Jacobs;H98;2;226;227921207;240556049;12634842
Jacobs;H98;10;126;1413129;10273523;8860394
Jacobs;H98;10;59;30674002;33898953;3224951
Jacobs;H98;10;16;36637311;37738237;1100926
Jacobs;H98;10;20;38727795;40071898;1344103
Jacobs;H98;10;61;41271768;45845544;4573776
Jacobs;H98;10;33;47287047;48804938;1517891
Jacobs;H98;10;35;57261965;59691651;2429686
Jacobs;H98;10;85;62418210;68311196;5892986
Jacobs;H98;10;82;82083004;86415081;4332077
Jacobs;H99;2;25;985851;2383174;1397323
Jacobs;H99;2;24;3930781;5011935;1081154
Jacobs;H99;2;16;5094572;5798140;703568
Jacobs;H99;2;30;14523912;16096373;1572461
Jacobs;H99;2;27;22809937;24092677;1282740
Jacobs;H99;2;18;24839164;25709378;870214
Jacobs;H99;2;16;31657214;32379564;722350
Jacobs;H99;2;108;93102704;99427585;6324881
Jacobs;H99;2;15;106975218;107573497;598279
Jacobs;H99;2;25;113113775;115340878;2227103
Jacobs;H99;2;104;122060498;127699622;5639124
Jacobs;H99;2;83;142709866;147821995;5112129
Jacobs;H99;2;67;180818063;184760567;3942504
Jacobs;H99;2;20;204364546;205403175;1038629
Jacobs;H99;2;27;211611196;213219804;1608608
Jacobs;H99;2;35;215844761;219694019;3849258
Jacobs;H99;2;25;223647440;224864722;1217282
Jacobs;H99;10;26;11178146;12600289;1422143
Jacobs;H99;10;18;15018558;16139981;1121423
Jacobs;H99;10;127;23305210;30129111;6823901
Jacobs;H99;10;38;36883392;40071898;3188506
Jacobs;H99;10;100;40771431;47487991;6716560
Jacobs;H99;10;16;54142960;55211505;1068545
Jacobs;H99;10;26;59887584;61065661;1178077
Jacobs;H99;10;16;69208998;69913567;704569
Jacobs;H99;10;29;74131332;75564317;1432985
Jacobs;H99;24;21;7454516;8489860;1035344
Jacobs;H99;24;86;15637488;22600531;6963043
Jacobs;H99;24;51;29155367;32495625;3340258
Jacobs;H99;24;51;37808477;41600515;3792038
Jacobs;H100;2;36;2451471;4166902;1715431
Jacobs;H100;2;73;22396321;26300198;3903877
Jacobs;H100;2;91;45658202;51384849;5726647
Jacobs;H100;2;49;54240741;56804497;2563756
Jacobs;H100;2;28;65402955;67012655;1609700
Jacobs;H100;2;103;79017511;84802665;5785154
Jacobs;H100;2;74;84938566;88789712;3851146
Jacobs;H100;2;20;107171359;107911874;740515
Jacobs;H100;2;16;108309773;108954373;644600
Jacobs;H100;2;19;121796989;123432784;1635795
Jacobs;H100;2;44;131727936;133577022;1849086
Jacobs;H100;2;35;140158515;141971484;1812969
Jacobs;H100;2;27;145994402;147821995;1827593
Jacobs;H100;2;16;215498705;217457102;1958397
Jacobs;H100;2;95;229248722;234947844;5699122
Jacobs;H100;2;21;247245173;248543195;1298022
Jacobs;H100;10;76;18930071;23126119;4196048
Jacobs;H100;10;283;30072709;47487991;17415282
Jacobs;H100;10;16;67609179;68694545;1085366
Jacobs;H100;10;33;74111393;75682529;1571136
Jacobs;H100;10;45;82477869;84741018;2263149
Jacobs;H100;24;72;11611963;16811910;5199947
Jacobs;H100;24;15;21629724;22855134;1225410
Jacobs;H100;24;37;24591560;27526097;2934537
Jacobs;H105;2;29;1906939;3291115;1384176
Jacobs;H105;2;70;10887825;14827510;3939685
Jacobs;H105;2;119;17969084;24092677;6123593
Jacobs;H105;2;18;24839164;25709378;870214
Jacobs;H105;2;16;31657214;32379564;722350
Jacobs;H105;2;49;54240741;56804497;2563756
Jacobs;H105;2;28;65402955;67012655;1609700
Jacobs;H105;2;49;69991657;73109758;3118101
Jacobs;H105;2;103;79017511;84802665;5785154
Jacobs;H105;2;74;84938566;88789712;3851146
Jacobs;H105;2;69;103618164;107627876;4009712
Jacobs;H105;2;17;122060498;123432784;1372286
Jacobs;H105;2;16;131727936;132323750;595814
Jacobs;H105;2;45;140158515;142506224;2347709
Jacobs;H105;2;431;143847759;168665722;24817963
Jacobs;H105;2;126;171228786;178764936;7536150
Jacobs;H105;2;77;187856073;192149660;4293587
Jacobs;H105;2;32;194853812;197093416;2239604
Jacobs;H105;2;39;199432096;201797379;2365283
Jacobs;H105;2;15;205305554;206180550;874996
Jacobs;H105;2;178;211611196;223908949;12297753
Jacobs;H105;10;17;14007878;14856146;848268
Jacobs;H105;10;37;30674002;32637918;1963916
Jacobs;H105;10;188;36637311;48696250;12058939
Jacobs;H105;10;24;67307992;68743197;1435205
Jacobs;H105;10;31;82225985;83855530;1629545
Jacobs;H105;24;72;11611963;16811910;5199947
Jacobs;H106;2;286;54240741;69079036;14838295
Jacobs;H106;2;52;93217367;95965733;2748366
Jacobs;H106;2;142;119490716;127070041;7579325
Jacobs;H106;2;17;130009715;130926896;917181
Jacobs;H106;2;43;152437856;155158608;2720752
Jacobs;H106;2;87;180818063;186224877;5406814
Jacobs;H106;2;15;198596572;199195240;598668
Jacobs;H106;2;45;234808295;236783616;1975321
Jacobs;H106;10;17;14007878;14856146;848268
Jacobs;H106;10;28;36883392;39457465;2574073
Jacobs;H106;10;19;40105937;40971187;865250
Jacobs;H106;10;18;46618259;47487991;869732
Jacobs;H106;10;39;47662790;49310196;1647406
Jacobs;H106;10;16;52284660;53098812;814152
Jacobs;H106;10;21;74631551;75682529;1050978
Jacobs;H106;24;15;6222497;6976657;754160
Jacobs;H106;24;26;8842899;10977878;2134979
Jacobs;H106;24;86;16041579;23184425;7142846
Jacobs;H107;2;49;5039528;7490500;2450972
Jacobs;H107;2;116;7727437;14159758;6432321
Jacobs;H107;2;40;24966147;27311358;2345211
Jacobs;H107;2;33;51824098;53415584;1591486
Jacobs;H107;2;16;53991275;54669270;677995
Jacobs;H107;2;236;54687816;66858417;12170601
Jacobs;H107;2;28;73475221;75042274;1567053
Jacobs;H107;2;101;84069275;90362958;6293683
Jacobs;H107;2;27;90945684;92162531;1216847
Jacobs;H107;2;16;98652142;99487592;835450
Jacobs;H107;2;20;113897647;115476148;1578501
Jacobs;H107;2;18;120634348;121330712;696364
Jacobs;H107;2;20;122060498;123528595;1468097
Jacobs;H107;2;72;156678409;161172554;4494145
Jacobs;H107;2;45;182286302;184673171;2386869
Jacobs;H107;2;39;199432096;201797379;2365283
Jacobs;H107;2;16;228130504;228848890;718386
Jacobs;H107;10;126;1413129;10273523;8860394
Jacobs;H107;10;121;23305210;29882404;6577194
Jacobs;H107;10;18;36448017;37738237;1290220
Jacobs;H107;10;20;38727795;40071898;1344103
Jacobs;H107;10;139;41271768;49560674;8288906
Jacobs;H107;10;35;57261965;59691651;2429686
Jacobs;H107;10;39;66062576;68311196;2248620
Jacobs;H107;10;80;74681400;78876406;4195006
Jacobs;H107;10;84;78950748;83213988;4263240
Jacobs;H107;24;26;8842899;10977878;2134979
Jacobs;H107;24;68;16351007;21910840;5559833
Jacobs;H107;24;18;33397677;34176391;778714
Jacobs;H113;2;174;27355362;38243345;10887983
Jacobs;H113;2;33;40099347;42499181;2399834
Jacobs;H113;2;57;63635636;66543498;2907862
Jacobs;H113;2;32;68216266;69880623;1664357
Jacobs;H113;2;19;75674121;76748382;1074261
Jacobs;H113;2;66;77918896;81273844;3354948
Jacobs;H113;2;52;93217367;95965733;2748366
Jacobs;H113;2;17;140158515;141007423;848908
Jacobs;H113;2;19;149720801;150755823;1035022
Jacobs;H113;2;105;151148561;157319697;6171136
Jacobs;H113;2;77;187856073;192149660;4293587
Jacobs;H113;2;32;194853812;197093416;2239604
Jacobs;H113;2;39;199432096;201797379;2365283
Jacobs;H113;2;42;205305554;207747048;2441494
Jacobs;H113;2;138;208232368;217890987;9658619
Jacobs;H113;2;183;231170715;241543820;10373105
Jacobs;H113;10;52;1413129;4903158;3490029
Jacobs;H113;10;49;4986490;9093522;4107032
Jacobs;H113;10;17;14007878;14856146;848268
Jacobs;H113;10;37;30674002;32637918;1963916
Jacobs;H113;10;247;36637311;51804306;15166995
Jacobs;H113;10;35;57261965;59691651;2429686
Jacobs;H113;10;28;66779341;68575459;1796118
Jacobs;H113;24;42;96467;3507572;3411105
Jacobs;H113;24;61;37349126;42027686;4678560
Jacobs;H114;2;54;2451471;4835268;2383797
Jacobs;H114;2;31;5986185;7490500;1504315
Jacobs;H114;2;146;22109813;30849683;8739870
Jacobs;H114;2;43;35582012;38602691;3020679
Jacobs;H114;2;16;53991275;54669270;677995
Jacobs;H114;2;103;79017511;84802665;5785154
Jacobs;H114;2;74;84938566;88789712;3851146
Jacobs;H114;2;316;101320194;121484489;20164295
Jacobs;H114;2;20;122060498;123528595;1468097
Jacobs;H114;2;22;133402369;134770618;1368249
Jacobs;H114;2;27;145994402;147821995;1827593
Jacobs;H114;2;16;215498705;217457102;1958397
Jacobs;H114;2;95;229248722;234947844;5699122
Jacobs;H114;10;139;1413129;10922307;9509178
Jacobs;H114;10;46;12231314;14856146;2624832
Jacobs;H114;10;36;21309973;23126119;1816146
Jacobs;H114;10;37;30674002;32637918;1963916
Jacobs;H114;10;28;36883392;39457465;2574073
Jacobs;H114;10;19;40105937;40971187;865250
Jacobs;H114;10;18;46618259;47487991;869732
Jacobs;H114;10;39;47662790;49310196;1647406
Jacobs;H114;10;15;54511117;55377753;866636
Jacobs;H114;10;47;56100245;59236641;3136396
Jacobs;H114;10;97;59298205;65768192;6469987
Jacobs;H114;10;42;73780536;75682529;1901993
Jacobs;H114;10;37;82687218;84537988;1850770
Jacobs;H114;24;17;96467;1377045;1280578
Jacobs;H114;24;16;11076801;12335936;1259135
Jacobs;H115;2;50;1906939;4351718;2444779
Jacobs;H115;2;16;53991275;54669270;677995
Jacobs;H115;2;217;56039866;67126344;11086478
Jacobs;H115;2;63;72875158;76627899;3752741
Jacobs;H115;2;74;84640849;88553200;3912351
Jacobs;H115;2;128;96566325;104101891;7535566
Jacobs;H115;2;24;118134501;119654696;1520195
Jacobs;H115;2;17;122060498;123432784;1372286
Jacobs;H115;2;36;130606432;132323750;1717318
Jacobs;H115;2;35;140158515;141971484;1812969
Jacobs;H115;2;22;154579541;155797260;1217719
Jacobs;H115;2;77;167901271;172311083;4409812
Jacobs;H115;2;16;215498705;217457102;1958397
Jacobs;H115;2;16;217890987;219015064;1124077
Jacobs;H115;2;21;220083076;221216169;1133093
Jacobs;H115;2;85;244012987;248799264;4786277
Jacobs;H115;10;16;33808019;34439731;631712
Jacobs;H115;10;28;36883392;39457465;2574073
Jacobs;H115;10;69;74111393;77556267;3444874
Jacobs;H115;24;68;26493858;31556086;5062228
Jacobs;H116;2;25;1717596;2877210;1159614
Jacobs;H116;2;32;51824098;53366034;1541936
Jacobs;H116;2;48;55946911;58102980;2156069
Jacobs;H116;2;28;65402955;67012655;1609700
Jacobs;H116;2;57;79017511;81785728;2768217
Jacobs;H116;2;87;84069275;88789712;4720437
Jacobs;H116;2;15;94981400;95731895;750495
Jacobs;H116;2;192;103331488;116465257;13133769
Jacobs;H116;2;20;122060498;123528595;1468097
Jacobs;H116;2;38;125343919;127088467;1744548
Jacobs;H116;2;27;127495017;129045322;1550305
Jacobs;H116;2;31;155026089;156678409;1652320
Jacobs;H116;2;16;157252102;158187310;935208
Jacobs;H116;2;20;198155571;199020889;865318
Jacobs;H116;2;42;199225518;201797379;2571861
Jacobs;H116;2;227;202088645;215251657;13163012
Jacobs;H116;10;78;17748924;22285343;4536419
Jacobs;H116;10;44;29842383;31770739;1928356
Jacobs;H116;10;34;36637311;39457465;2820154
Jacobs;H116;10;130;56946876;65768192;8821316
Jacobs;H116;10;52;67307992;70187303;2879311
Jacobs;H116;10;56;71426400;74728587;3302187
Jacobs;H116;24;96;29375887;35991517;6615630
Jacobs;H26;2;15;5940814;6740866;800052
Jacobs;H26;2;100;10782174;16096373;5314199
Jacobs;H26;2;16;53991275;54669270;677995
Jacobs;H26;2;112;68216266;74824143;6607877
Jacobs;H26;2;54;84938566;87916949;2978383
Jacobs;H26;2;44;91063757;93513090;2449333
Jacobs;H26;2;54;118497369;121330712;2833343
Jacobs;H26;2;28;121455578;123432784;1977206
Jacobs;H26;2;16;133402369;134244380;842011
Jacobs;H26;2;33;138618372;140273577;1655205
Jacobs;H26;2;61;141007423;144457580;3450157
Jacobs;H26;2;34;205244432;207231826;1987394
Jacobs;H26;2;39;212342465;215251657;2909192
Jacobs;H26;2;50;216032030;220852308;4820278
Jacobs;H26;2;20;226617529;227734587;1117058
Jacobs;H26;2;43;231170715;233623788;2453073
Jacobs;H26;10;36;1413129;4075086;2661957
Jacobs;H26;10;49;5450092;9318987;3868895
Jacobs;H26;10;48;15018558;17748924;2730366
Jacobs;H26;10;28;36883392;39457465;2574073
Jacobs;H26;10;29;42731359;45083665;2352306
Jacobs;H26;10;16;52284660;53098812;814152
Jacobs;H26;10;49;55944722;59143370;3198648
Jacobs;H26;10;28;67609179;69311273;1702094
Jacobs;H26;10;68;82225985;85889796;3663811
Jacobs;H26;24;69;16351007;22222030;5871023
Jacobs;H26;24;26;24776080;26681408;1905328
Jacobs;H32;2;18;158066;1625350;1467284
Jacobs;H32;2;90;1675016;6092514;4417498
Jacobs;H32;2;60;8218127;11400715;3182588
Jacobs;H32;2;21;114411448;115743360;1331912
Jacobs;H32;2;15;116108127;117115355;1007228
Jacobs;H32;2;28;121590788;123528595;1937807
Jacobs;H32;2;53;135178922;138159566;2980644
Jacobs;H32;2;23;152529090;154052685;1523595
Jacobs;H32;10;15;21811328;22650915;839587
Jacobs;H32;10;27;29353089;30618253;1265164
Jacobs;H32;10;37;30674002;32637918;1963916
Jacobs;H32;10;38;36883392;40071898;3188506
Jacobs;H32;10;116;40771431;48243886;7472455
Jacobs;H32;10;19;50876668;51659456;782788
Jacobs;H32;10;72;52515784;57089480;4573696
Jacobs;H32;10;50;65931464;68743197;2811733
Jacobs;H32;10;130;71426400;78641554;7215154
Jacobs;H32;24;31;17307132;19741398;2434266
Jacobs;H32;24;19;24776080;25961188;1185108
Navajo-Churro;H38;2;15;54086367;54687816;601449
Navajo-Churro;H38;2;15;113113775;114558942;1445167
Navajo-Churro;H38;2;21;131682707;132526868;844161
Navajo-Churro;H38;2;19;166996675;167955730;959055
Navajo-Churro;H38;24;16;1938133;3031957;1093824
Navajo-Churro;H44;2;55;53837176;56521561;2684385
Navajo-Churro;H44;2;15;113113775;114558942;1445167
Navajo-Churro;H44;2;17;148274554;149186801;912247
Navajo-Churro;H44;2;661;160549720;199498132;38948412
Navajo-Churro;H44;2;19;234269471;235184763;915292
Navajo-Churro;H44;10;81;24187107;28438915;4251808
Navajo-Churro;H44;10;25;28502457;29806294;1303837
Navajo-Churro;H44;10;17;35528316;36385864;857548
Navajo-Churro;H44;10;22;40105937;41210470;1104533
Navajo-Churro;H44;10;22;57077569;58143024;1065455
Navajo-Churro;H44;10;154;78520137;86415081;7894944
Navajo-Churro;H56;2;74;158066;4370486;4212420
Navajo-Churro;H56;2;172;86057456;95965733;9908277
Navajo-Churro;H56;2;15;113113775;114558942;1445167
Navajo-Churro;H56;2;18;178045098;179079150;1034052
Navajo-Churro;H56;2;98;210045166;216807667;6762501
Navajo-Churro;H56;10;22;33648969;34569205;920236
Navajo-Churro;H56;10;23;43647988;44929212;1281224
Jacobs;H50;2;22;6349125;7490500;1141375
Jacobs;H50;2;52;7727437;10649928;2922491
Jacobs;H50;2;19;30109974;31144311;1034337
Jacobs;H50;2;73;55415073;58791324;3376251
Jacobs;H50;2;20;65402955;66543498;1140543
Jacobs;H50;2;90;70802060;76075819;5273759
Jacobs;H50;2;94;92631842;98008059;5376217
Jacobs;H50;2;360;98817919;121330712;22512793
Jacobs;H50;2;20;122001925;123494681;1492756
Jacobs;H50;2;31;128510347;130206119;1695772
Jacobs;H50;2;16;131727936;132323750;595814
Jacobs;H50;2;24;136745970;138081646;1335676
Jacobs;H50;2;407;176765339;201496886;24731547
Jacobs;H50;2;72;230657435;234947844;4290409
Jacobs;H50;10;146;1413129;11356894;9943765
Jacobs;H50;10;18;22014650;22955949;941299
Jacobs;H50;10;15;32446306;33296865;850559
Jacobs;H50;10;33;33898953;35371668;1472715
Jacobs;H50;10;28;36883392;39457465;2574073
Jacobs;H50;10;19;40105937;40971187;865250
Jacobs;H50;10;17;46618259;47385192;766933
Jacobs;H50;10;17;50699349;51490237;790888
Jacobs;H50;10;82;55944722;60841810;4897088
Jacobs;H50;10;43;84100127;86415081;2314954
Jacobs;H50;24;27;4000350;5874652;1874302
Jacobs;H50;24;29;5978910;7615311;1636401
Jacobs;H50;24;22;7721963;8842899;1120936
Jacobs;H50;24;164;12065734;24690825;12625091
Jacobs;H50;24;17;32598869;33503397;904528
Jacobs;H27;2;395;158066;21690410;21532344
Jacobs;H27;2;32;68216266;69880623;1664357
Jacobs;H27;2;130;84640849;92162531;7521682
Jacobs;H27;2;72;96566325;100951258;4384933
Jacobs;H27;2;17;122060498;123432784;1372286
Jacobs;H27;2;44;131727936;133577022;1849086
Jacobs;H27;2;42;186306661;188785740;2479079
Jacobs;H27;2;115;189799453;196397256;6597803
Jacobs;H27;2;163;209050239;220852308;11802069
Jacobs;H27;2;17;227127050;228074336;947286
Jacobs;H27;10;18;8894322;9736034;841712
Jacobs;H27;10;16;13056079;13855191;799112
Jacobs;H27;10;39;14573661;16744641;2170980
Jacobs;H27;10;15;20482744;21309973;827229
Jacobs;H27;10;128;36883392;46200425;9317033
Jacobs;H27;10;25;46264587;47385192;1120605
Jacobs;H27;10;23;52768972;54375509;1606537
Jacobs;H27;10;17;67609179;68743197;1134018
Jacobs;H27;10;41;75314642;77276861;1962219
Jacobs;H27;24;62;15510478;20406106;4895628
Navajo-Churro;H33;2;23;23460849;24646366;1185517
Navajo-Churro;H33;2;21;69880623;71218360;1337737
Navajo-Churro;H33;2;21;99399983;100718159;1318176
Navajo-Churro;H33;2;20;107258684;107989499;730815
Navajo-Churro;H33;2;17;108264568;108954373;689805
Navajo-Churro;H33;2;278;116992107;132056189;15064082
Navajo-Churro;H33;2;16;134301618;135178922;877304
Navajo-Churro;H33;2;19;141192562;142123229;930667
Navajo-Churro;H33;2;15;149539226;150249776;710550
Navajo-Churro;H33;2;21;182124730;183164212;1039482
Navajo-Churro;H33;2;16;215680487;217719922;2039435
Navajo-Churro;H33;2;35;223856449;225533687;1677238
Navajo-Churro;H33;10;15;28502457;29304176;801719
Navajo-Churro;H33;10;22;43417893;44708676;1290783
Navajo-Churro;H33;10;32;50058081;51782008;1723927
Navajo-Churro;H33;10;51;71521530;74592356;3070826
Navajo-Churro;H33;10;15;81397746;81950954;553208
Navajo-Churro;H33;10;18;82994149;83807586;813437
Navajo-Churro;H33;24;28;32623905;34113252;1489347
Navajo-Churro;H39;2;25;14359717;15424986;1065269
Navajo-Churro;H39;2;330;75848139;94525031;18676892
Navajo-Churro;H39;2;15;102804384;103629915;825531
Navajo-Churro;H39;2;229;105702129;120634348;14932219
Navajo-Churro;H39;2;16;121515740;122429181;913441
Navajo-Churro;H39;2;17;189799453;190643587;844134
Navajo-Churro;H39;2;18;223762044;224527713;765669
Navajo-Churro;H39;10;25;42242344;44495989;2253645
Navajo-Churro;H45;2;440;158066;23881589;23723523
Navajo-Churro;H45;2;16;71387561;72284971;897410
Navajo-Churro;H45;2;15;80376822;80942245;565423
Navajo-Churro;H45;2;65;92162531;95965733;3803202
Navajo-Churro;H45;2;15;153972547;154723424;750877
Navajo-Churro;H45;2;16;159278703;160185941;907238
Navajo-Churro;H45;2;34;228977129;230789586;1812457
Navajo-Churro;H45;10;97;2769146;9416750;6647604
Navajo-Churro;H45;24;16;9658771;11232313;1573542
Navajo-Churro;H45;24;16;20734455;21910840;1176385
Navajo-Churro;H45;24;19;22329952;23689555;1359603
Navajo-Churro;H45;24;16;25614223;26759068;1144845
Navajo-Churro;H45;24;17;36938439;37753985;815546
Jacobs;H51;2;82;158066;4697573;4539507
Jacobs;H51;2;96;7672558;13078663;5406105
Jacobs;H51;2;24;17033754;18083119;1049365
Jacobs;H51;2;27;22809937;24092677;1282740
Jacobs;H51;2;79;24839164;29960448;5121284
Jacobs;H51;2;33;51824098;53415584;1591486
Jacobs;H51;2;16;53991275;54669270;677995
Jacobs;H51;2;28;54687816;56154368;1466552
Jacobs;H51;2;125;59972946;66543498;6570552
Jacobs;H51;2;17;70802060;71793127;991067
Jacobs;H51;2;20;107171359;107911874;740515
Jacobs;H51;2;16;108309773;108954373;644600
Jacobs;H51;2;19;121796989;123432784;1635795
Jacobs;H51;2;47;132841528;135391568;2550040
Jacobs;H51;2;24;136745970;138081646;1335676
Jacobs;H51;2;87;142676162;147996276;5320114
Jacobs;H51;2;21;159437585;160694589;1257004
Jacobs;H51;2;246;186306661;200658492;14351831
Jacobs;H51;2;15;205305554;206180550;874996
Jacobs;H51;2;178;208232368;220903491;12671123
Jacobs;H51;2;23;221624187;222800960;1176773
Jacobs;H51;2;52;233377856;235857471;2479615
Jacobs;H51;10;171;1413129;13056079;11642950
Jacobs;H51;10;692;20839740;61065661;40225921
Jacobs;H51;10;77;82477869;86415081;3937212
Jacobs;H51;24;134;12036238;22329952;10293714
Jacobs;H57;2;50;1906939;4351718;2444779
Jacobs;H57;2;514;39586061;68412890;28826829
Jacobs;H57;2;211;91143985;103407822;12263837
Jacobs;H57;2;118;140655290;147650770;6995480
Jacobs;H57;2;126;199432096;206180550;6748454
Jacobs;H57;2;25;209050239;210418618;1368379
Jacobs;H57;2;28;215844761;219015064;3170303
Jacobs;H57;10;17;14007878;14856146;848268
Jacobs;H57;10;41;15587696;17748924;2161228
Jacobs;H57;10;24;32968431;34175819;1207388
Jacobs;H57;10;16;36637311;37738237;1100926
Jacobs;H57;10;31;41802553;44430609;2628056
Jacobs;H57;10;35;50876668;52388827;1512159
Jacobs;H57;10;29;53098812;54955412;1856600
Jacobs;H57;10;123;62065368;70187303;8121935
Jacobs;H57;10;109;71426400;77507372;6080972
Jacobs;H57;10;16;77939102;78803876;864774
Jacobs;H57;10;34;84696261;86415081;1718820
Jacobs;H57;24;94;17040364;24629625;7589261
Jacobs;H57;24;115;33313461;42027686;8714225
Navajo-Churro;H28;2;70;80904183;84938566;4034383
Navajo-Churro;H28;2;17;103778735;104876321;1097586
Navajo-Churro;H28;2;26;108235636;109487038;1251402
Navajo-Churro;H28;2;22;129537914;130831021;1293107
Navajo-Churro;H28;2;22;148479250;149505811;1026561
Navajo-Churro;H28;2;35;238249575;240012290;1762715
Navajo-Churro;H28;10;54;30849548;33843863;2994315
Navajo-Churro;H28;10;21;36847123;38751668;1904545
Navajo-Churro;H28;10;23;41420084;43591931;2171847
Navajo-Churro;H34;2;68;14272947;17733005;3460058
Navajo-Churro;H34;2;168;17834999;26807018;8972019
Navajo-Churro;H34;2;292;75799552;92095417;16295865
Navajo-Churro;H34;2;65;92162531;95965733;3803202
Navajo-Churro;H34;2;217;160549720;172424726;11875006
Navajo-Churro;H34;2;168;172516697;183252529;10735832
Navajo-Churro;H34;2;71;183389553;187836750;4447197
Navajo-Churro;H34;2;136;187916592;195861753;7945161
Navajo-Churro;H34;2;23;202249334;203171974;922640
Navajo-Churro;H34;2;79;236398303;241057841;4659538
Navajo-Churro;H34;2;30;241298301;243050370;1752069
Navajo-Churro;H34;10;81;24187107;28438915;4251808
Navajo-Churro;H34;10;25;28502457;29806294;1303837
Navajo-Churro;H34;10;17;35528316;36385864;857548
Navajo-Churro;H34;10;22;40105937;41210470;1104533
Navajo-Churro;H34;10;17;57077569;57892745;815176
Navajo-Churro;H34;10;18;71470411;72901888;1431477
Jacobs;H40;2;23;158066;1815412;1657346
Jacobs;H40;2;16;53991275;54669270;677995
Jacobs;H40;2;81;70802060;75644823;4842763
Jacobs;H40;2;217;103466624;117835621;14368997
Jacobs;H40;2;165;118099428;127070041;8970613
Jacobs;H40;2;132;133402369;140897169;7494800
Jacobs;H40;2;193;193176635;203989901;10813266
Jacobs;H40;2;15;205305554;206180550;874996
Jacobs;H40;2;46;212342465;215498705;3156240
Jacobs;H40;2;162;216032030;226569909;10537879
Jacobs;H40;2;15;232591652;233589543;997891
Jacobs;H40;10;46;1413129;4649782;3236653
Jacobs;H40;10;16;11178146;11920339;742193
Jacobs;H40;10;38;15733590;17748924;2015334
Jacobs;H40;10;29;36637311;39072962;2435651
Jacobs;H40;10;17;46618259;47385192;766933
Jacobs;H40;10;35;50876668;52388827;1512159
Jacobs;H40;10;49;55944722;59143370;3198648
Jacobs;H40;10;52;67307992;70187303;2879311
Jacobs;H40;10;103;71426400;77142109;5715709
Jacobs;H40;10;16;77939102;78803876;864774
Jacobs;H40;10;34;84696261;86415081;1718820
Jacobs;H40;24;106;5485098;12550566;7065468
Jacobs;H40;24;62;17040364;21910840;4870476
Jacobs;H40;24;17;40336394;42027686;1691292
Jacobs;H46;2;50;1906939;4351718;2444779
Jacobs;H46;2;75;4431496;8561759;4130263
Jacobs;H46;2;27;22809937;24092677;1282740
Jacobs;H46;2;88;24839164;30589213;5750049
Jacobs;H46;2;38;46219946;48824104;2604158
Jacobs;H46;2;82;53366034;57495366;4129332
Jacobs;H46;2;42;89567061;92132718;2565657
Jacobs;H46;2;27;93217367;94609125;1391758
Jacobs;H46;2;20;122060498;123528595;1468097
Jacobs;H46;2;56;131165894;133748186;2582292
Jacobs;H46;2;15;134667278;135391568;724290
Jacobs;H46;2;118;140655290;147650770;6995480
Jacobs;H46;2;30;215774413;219015064;3240651
Jacobs;H46;2;15;220083076;220955491;872415
Jacobs;H46;10;218;1413129;15733590;14320461
Jacobs;H46;10;24;32968431;34175819;1207388
Jacobs;H46;10;16;36637311;37738237;1100926
Jacobs;H46;10;31;41802553;44430609;2628056
Jacobs;H46;10;35;50876668;52388827;1512159
Jacobs;H46;10;29;53098812;54955412;1856600
Jacobs;H46;10;60;55944722;59776861;3832139
Jacobs;H46;10;23;63706057;65269159;1563102
Jacobs;H46;10;21;67307992;68575459;1267467
Jacobs;H46;10;48;78950748;81397746;2446998
Jacobs;H46;10;34;84696261;86415081;1718820
Jacobs;H46;24;61;5485098;8842899;3357801
Jacobs;H46;24;49;17996334;22222030;4225696
Jacobs;H46;24;20;33313461;34176391;862930
Jacobs;H46;24;15;39300789;40256403;955614
Navajo-Churro;H52;2;23;50949347;52327990;1378643
Navajo-Churro;H52;2;17;80304321;80942245;637924
Navajo-Churro;H52;2;23;113664053;115525483;1861430
Navajo-Churro;H52;2;16;132526868;133133629;606761
Navajo-Churro;H52;2;16;218592494;219933911;1341417
Navajo-Churro;H52;10;15;11027862;11853718;825856
Navajo-Churro;H52;10;21;29502667;30490110;987443
Navajo-Churro;H52;10;18;32465060;33582901;1117841
Navajo-Churro;H58;2;17;110228019;111172962;944943
Navajo-Churro;H58;10;47;25827394;28438915;2611521
Navajo-Churro;H58;10;33;28502457;30129111;1626654
Navajo-Churro;H29;2;38;11728531;13794213;2065682
Navajo-Churro;H29;2;18;33837135;34792034;954899
Navajo-Churro;H29;2;20;63770877;64622544;851667
Navajo-Churro;H29;2;20;67534697;68553052;1018355
Navajo-Churro;H29;2;24;86669812;87879884;1210072
Navajo-Churro;H29;2;35;107745785;109487038;1741253
Navajo-Churro;H29;2;19;116465257;117413762;948505
Navajo-Churro;H29;2;55;187836750;190978310;3141560
Navajo-Churro;H29;10;16;33986642;34667432;680790
Navajo-Churro;H29;10;16;77276861;78182508;905647
Navajo-Churro;H29;24;107;21629724;29910952;8281228
Jacobs;H35;2;16;10266961;10887825;620864
Jacobs;H35;2;18;39411236;40350901;939665
Jacobs;H35;2;33;42499181;44430836;1931655
Jacobs;H35;2;152;49169218;57182355;8013137
Jacobs;H35;2;78;70946621;75644823;4698202
Jacobs;H35;2;38;84069275;86380895;2311620
Jacobs;H35;2;29;91143985;92891269;1747284
Jacobs;H35;2;18;112551575;114279784;1728209
Jacobs;H35;2;66;122001925;125776688;3774763
Jacobs;H35;2;71;136336816;140273577;3936761
Jacobs;H35;2;45;141299872;143864562;2564690
Jacobs;H35;2;32;145745763;147821995;2076232
Jacobs;H35;2;21;159437585;160694589;1257004
Jacobs;H35;2;192;207575434;220852308;13276874
Jacobs;H35;2;17;227127050;228074336;947286
Jacobs;H35;2;72;228485892;232485668;3999776
Jacobs;H35;2;260;232554453;247635266;15080813
Jacobs;H35;10;40;1413129;4354367;2941238
Jacobs;H35;10;39;4428848;7016861;2588013
Jacobs;H35;10;86;7208458;12770970;5562512
Jacobs;H35;10;16;13056079;13855191;799112
Jacobs;H35;10;39;14573661;16744641;2170980
Jacobs;H35;10;15;20482744;21309973;827229
Jacobs;H35;10;28;36883392;39457465;2574073
Jacobs;H35;10;17;46618259;47385192;766933
Jacobs;H35;10;72;50699349;54398140;3698791
Jacobs;H35;10;74;66062576;70187303;4124727
Jacobs;H35;10;53;71426400;74592356;3165956
Jacobs;H35;10;32;74752408;76428043;1675635
Jacobs;H35;10;28;76572836;77939102;1366266
Jacobs;H35;10;79;82225985;86415081;4189096
Jacobs;H35;24;48;96467;4116377;4019910
Jacobs;H35;24;25;7564606;8842899;1278293
Jacobs;H35;24;18;30412150;31568788;1156638
Navajo-Churro;H41;2;30;12636461;14159758;1523297
Navajo-Churro;H41;2;323;66226023;84640849;18414826
Navajo-Churro;H41;2;96;92631842;98270309;5638467
Navajo-Churro;H41;2;198;98483096;109731343;11248247
Navajo-Churro;H41;2;42;109829764;113916007;4086243
Navajo-Churro;H41;2;58;114224745;117573048;3348303
Navajo-Churro;H41;2;224;139597601;152203740;12606139
Navajo-Churro;H41;2;338;167955730;188979493;21023763
Navajo-Churro;H41;2;15;209901734;210708881;807147
Navajo-Churro;H41;2;21;236027912;237315458;1287546
Navajo-Churro;H41;10;29;4405111;6254810;1849699
Navajo-Churro;H41;10;22;38089234;39816919;1727685
Navajo-Churro;H41;10;30;42049970;44519802;2469832
Navajo-Churro;H41;24;95;962868;7615311;6652443
Navajo-Churro;H41;24;19;20442734;21878624;1435890
Jacobs;H47;2;79;6092514;10537097;4444583
Jacobs;H47;2;437;34792034;60044110;25252076
Jacobs;H47;2;265;60131740;75042274;14910534
Jacobs;H47;2;16;109766460;110765081;998621
Jacobs;H47;2;159;118099428;126734704;8635276
Jacobs;H47;2;111;206510663;212749665;6239002
Jacobs;H47;2;22;213790888;215641893;1851005
Jacobs;H47;10;95;12231314;17609318;5378004
Jacobs;H47;10;16;18930071;19700851;770780
Jacobs;H47;10;171;21517842;30618253;9100411
Jacobs;H47;10;37;30674002;32637918;1963916
Jacobs;H47;10;18;36448017;37738237;1290220
Jacobs;H47;10;20;38727795;40071898;1344103
Jacobs;H47;10;28;53666062;55377753;1711691
Jacobs;H47;10;62;57335879;61065661;3729782
Jacobs;H47;10;61;74131332;77142109;3010777
Jacobs;H47;24;17;96467;1377045;1280578
Jacobs;H47;24;17;7483090;8339627;856537
Jacobs;H47;24;24;8842899;10709974;1867075
Jacobs;H47;24;88;13558686;19741398;6182712
Navajo-Churro;H53;2;18;4008763;4739830;731067
Navajo-Churro;H53;2;18;6587778;7413337;825559
Navajo-Churro;H53;2;135;121455578;128762227;7306649
Navajo-Churro;H53;2;23;131596312;132526868;930556
Navajo-Churro;H53;2;19;144227691;145234800;1007109
Navajo-Churro;H53;2;16;148953266;149546970;593704
Navajo-Churro;H53;2;20;193596846;194853812;1256966
Navajo-Churro;H53;2;17;200160117;201345538;1185421
Navajo-Churro;H53;2;18;212793217;213756591;963374
Navajo-Churro;H53;2;86;231834142;236285593;4451451
Navajo-Churro;H53;2;20;238041313;239031909;990596
Navajo-Churro;H53;10;26;42242344;44519802;2277458
Navajo-Churro;H53;10;16;69208998;69913567;704569
Navajo-Churro;H53;10;15;74187529;74893559;706030
Navajo-Churro;H53;24;107;6647168;14275553;7628385
Navajo-Churro;H53;24;23;24989534;26759068;1769534
Jacobs;H59;2;88;158066;5039528;4881462
Jacobs;H59;2;119;16487040;22664271;6177231
Jacobs;H59;2;21;114411448;115743360;1331912
Jacobs;H59;2;15;116108127;117115355;1007228
Jacobs;H59;2;19;121590788;123048197;1457409
Jacobs;H59;2;38;131916165;133577022;1660857
Jacobs;H59;2;77;133655932;138159566;4503634
Jacobs;H59;2;23;152529090;154052685;1523595
Jacobs;H59;2;15;163564272;164349110;784838
Jacobs;H59;2;15;175790038;177011834;1221796
Jacobs;H59;2;45;182286302;184673171;2386869
Jacobs;H59;10;15;10155086;10839165;684079
Jacobs;H59;10;16;20482744;21363789;881045
Jacobs;H59;10;35;36883392;39942731;3059339
Jacobs;H59;10;23;52768972;54375509;1606537
Jacobs;H59;10;16;54459673;55377753;918080
Jacobs;H59;10;64;57261965;61065661;3803696
Jacobs;H59;10;35;68339290;70187303;1848013
Jacobs;H59;10;130;71426400;78641554;7215154
Jacobs;H59;10;74;80545891;84137492;3591601
Jacobs;H59;24;30;22222030;24493823;2271793
Navajo-Churro;H30;2;15;52924011;53725483;801472
Navajo-Churro;H30;2;205;86333486;98682513;12349027
Navajo-Churro;H30;2;339;98817919;120426576;21608657
Navajo-Churro;H30;2;16;218592494;219933911;1341417
Navajo-Churro;H30;2;15;240647987;241506698;858711
Navajo-Churro;H30;10;24;35629123;36950734;1321611
Navajo-Churro;H30;10;17;68271380;69208998;937618
Navajo-Churro;H30;24;16;26068027;27620251;1552224
Navajo-Churro;H42;2;17;30173541;31018254;844713
Navajo-Churro;H42;2;60;67927937;71490850;3562913
Navajo-Churro;H42;2;18;183793517;184813524;1020007
Navajo-Churro;H42;2;193;220702849;230748446;10045597
Jacobs;H48;2;15;5940814;6740866;800052
Jacobs;H48;2;75;10782174;14827510;4045336
Jacobs;H48;2;68;67597692;71671999;4074307
Jacobs;H48;2;145;92213984;100951258;8737274
Jacobs;H48;2;17;122060498;123432784;1372286
Jacobs;H48;2;29;139520902;140897169;1376267
Jacobs;H48;2;31;142593638;144457580;1863942
Jacobs;H48;2;16;172745053;173584797;839744
Jacobs;H48;2;39;176369323;178764936;2395613
Jacobs;H48;2;111;193176635;199777656;6601021
Jacobs;H48;2;18;211611196;212749665;1138469
Jacobs;H48;2;23;231170715;232414241;1243526
Jacobs;H48;10;26;21584008;22955949;1371941
Jacobs;H48;10;103;25190096;30618253;5428157
Jacobs;H48;10;36;36847123;39942731;3095608
Jacobs;H48;10;20;51626765;52388827;762062
Jacobs;H48;10;17;67609179;68743197;1134018
Jacobs;H48;10;41;75314642;77276861;1962219
Jacobs;H48;24;38;10176168;13558686;3382518
Jacobs;H48;24;78;15510478;21629724;6119246
Jacobs;H48;24;23;28037384;29475441;1438057
Jacobs;H54;2;28;10782174;12330936;1548762
Jacobs;H54;2;15;25850068;26807018;956950
Jacobs;H54;2;35;39240476;41530444;2289968
Jacobs;H54;2;24;74785937;76075819;1289882
Jacobs;H54;2;26;90945684;92132718;1187034
Jacobs;H54;2;20;107171359;107911874;740515
Jacobs;H54;2;16;108309773;108954373;644600
Jacobs;H54;2;19;121796989;123432784;1635795
Jacobs;H54;2;37;126734704;128762227;2027523
Jacobs;H54;2;30;142709866;144532167;1822301
Jacobs;H54;2;25;153765602;155158608;1393006
Jacobs;H54;2;256;186306661;201153924;14847263
Jacobs;H54;2;58;214020092;219694019;5673927
Jacobs;H54;2;17;227127050;228074336;947286
Jacobs;H54;10;20;2277631;3333520;1055889
Jacobs;H54;10;42;16378011;18737350;2359339
Jacobs;H54;10;17;19096234;20012837;916603
Jacobs;H54;10;38;36883392;40071898;3188506
Jacobs;H54;10;116;40771431;48243886;7472455
Jacobs;H54;10;70;74131332;77753126;3621794
Jacobs;H54;24;19;4936555;6001198;1064643
Jacobs;H54;24;133;13231049;23418622;10187573
Jacobs;H54;24;185;26493858;39711452;13217594
Navajo-Churro;H60;2;55;53837176;56521561;2684385
Navajo-Churro;H60;2;67;77547185;80811295;3264110
Navajo-Churro;H60;2;779;84580673;131210129;46629456
Navajo-Churro;H60;2;22;171889296;172917684;1028388
Navajo-Churro;H60;2;22;197468568;198563117;1094549
Navajo-Churro;H60;2;191;230823473;241649475;10826002
Navajo-Churro;H60;10;15;2439198;3275097;835899
Navajo-Churro;H60;10;36;14237125;16338178;2101053
Navajo-Churro;H60;10;20;35885222;36883392;998170
Navajo-Churro;H60;10;26;43417893;44929212;1511319
Navajo-Churro;H60;10;16;71470411;72848051;1377640
Navajo-Churro;H60;24;69;16351007;22222030;5871023
Navajo-Churro;H60;24;18;26068027;27739247;1671220
Navajo-Churro;H31;2;54;48537833;51529698;2991865
Navajo-Churro;H31;2;21;73828642;74945550;1116908
Navajo-Churro;H31;2;15;113113775;114558942;1445167
Navajo-Churro;H31;2;15;229965518;230789586;824068
Navajo-Churro;H31;10;17;46714199;47513384;799185
Navajo-Churro;H31;10;20;49560674;50876668;1315994
Navajo-Churro;H31;10;22;57077569;58143024;1065455
Navajo-Churro;H37;2;16;2157185;2756505;599320
Navajo-Churro;H37;2;18;6740866;7490500;749634
Navajo-Churro;H37;2;64;43260410;46912545;3652135
Navajo-Churro;H37;2;21;73828642;74945550;1116908
Navajo-Churro;H37;2;15;113113775;114558942;1445167
Navajo-Churro;H37;2;23;132289224;133229013;939789
Navajo-Churro;H37;2;17;244212834;245030239;817405
Navajo-Churro;H37;10;144;54046513;63706057;9659544
Navajo-Churro;H43;2;17;148274554;149186801;912247
Navajo-Churro;H43;2;1119;160549720;226958743;66409023
Navajo-Churro;H43;10;15;40378968;41178516;799548
Navajo-Churro;H43;10;23;77276861;78520137;1243276
Navajo-Churro;H49;2;18;6587778;7413337;825559
Navajo-Churro;H49;2;18;63770877;64542824;771947
Navajo-Churro;H49;2;16;66608553;67488344;879791
Navajo-Churro;H49;2;16;108264568;108906253;641685
Navajo-Churro;H49;2;15;121734938;123048197;1313259
Navajo-Churro;H49;2;16;125030378;125571722;541344
Navajo-Churro;H49;2;98;210045166;216807667;6762501
Navajo-Churro;H49;2;17;244212834;245030239;817405
Navajo-Churro;H49;10;16;36165189;36883392;718203
Navajo-Churro;H49;10;26;43417893;44929212;1511319
Navajo-Churro;H49;10;55;51532474;54398140;2865666
Navajo-Churro;H49;24;77;7107585;12550566;5442981
Jacobs;H55;2;19;5039528;5986185;946657
Jacobs;H55;2;137;43184130;51529698;8345568
Jacobs;H55;2;16;53991275;54669270;677995
Jacobs;H55;2;20;65402955;66543498;1140543
Jacobs;H55;2;32;68216266;69880623;1664357
Jacobs;H55;2;34;72790181;74824143;2033962
Jacobs;H55;2;96;77293547;81785728;4492181
Jacobs;H55;2;73;92162531;96330247;4167716
Jacobs;H55;2;20;122060498;123528595;1468097
Jacobs;H55;2;65;139163515;142506224;3342709
Jacobs;H55;2;35;157010221;159278703;2268482
Jacobs;H55;2;130;165546958;172917684;7370726
Jacobs;H55;2;19;242462366;243302892;840526
Jacobs;H55;10;26;12019649;13605338;1585689
Jacobs;H55;10;39;14184398;16407508;2223110
Jacobs;H55;10;141;25943893;33603059;7659166
Jacobs;H55;10;34;36637311;39457465;2820154
Jacobs;H55;10;18;46618259;47487991;869732
Jacobs;H55;10;28;53666062;55377753;1711691
Jacobs;H55;10;25;57261965;59054630;1792665
Jacobs;H55;24;67;12722014;17307132;4585118
Jacobs;H55;24;36;17996334;20918106;2921772
Jacobs;H55;24;18;33397677;34176391;778714
Navajo-Churro;H1;2;36;71434200;73475221;2041021
Navajo-Churro;H1;2;67;77547185;80811295;3264110
Navajo-Churro;H1;2;69;84580673;88218618;3637945
Navajo-Churro;H1;2;16;148953266;149546970;593704
Navajo-Churro;H1;2;15;198495174;199110298;615124
Navajo-Churro;H1;2;36;202088645;203751286;1662641
Navajo-Churro;H1;10;36;49411181;51591083;2179902
Navajo-Churro;H1;10;41;80375552;82160471;1784919
Navajo-Churro;H1;24;18;26068027;27739247;1671220
Navajo-Churro;H9;2;81;9792510;13932966;4140456
Navajo-Churro;H9;2;1498;29912263;117934792;88022529
Navajo-Churro;H9;2;19;131793590;132550706;757116
Navajo-Churro;H9;2;124;151200968;158665480;7464512
Navajo-Churro;H9;2;229;178922457;192869029;13946572
Navajo-Churro;H9;2;110;236541718;243221593;6679875
Navajo-Churro;H9;10;16;30321628;30993691;672063
Navajo-Churro;H9;10;21;36847123;38751668;1904545
Navajo-Churro;H9;24;40;29652597;32390507;2737910
Jacobs;H17;2;109;158066;6092514;5934448
Jacobs;H17;2;20;15581003;16743751;1162748
Jacobs;H17;2;81;70802060;75644823;4842763
Jacobs;H17;2;26;90945684;92132718;1187034
Jacobs;H17;2;20;107171359;107911874;740515
Jacobs;H17;2;16;108309773;108954373;644600
Jacobs;H17;2;21;121796989;123494681;1697692
Jacobs;H17;2;462;126734704;152437856;25703152
Jacobs;H17;2;21;159437585;160694589;1257004
Jacobs;H17;2;133;164250208;171858694;7608486
Jacobs;H17;2;44;186410235;189054231;2643996
Jacobs;H17;2;31;204997139;206643029;1645890
Jacobs;H17;2;18;211611196;212749665;1138469
Jacobs;H17;2;29;230789586;232414241;1624655
Jacobs;H17;2;16;233988816;234947844;959028
Jacobs;H17;2;52;240967385;244212834;3245449
Jacobs;H17;10;49;21309973;23902878;2592905
Jacobs;H17;10;15;32773769;33603059;829290
Jacobs;H17;10;34;36637311;39457465;2820154
Jacobs;H17;10;17;46618259;47385192;766933
Jacobs;H17;10;19;50876668;51659456;782788
Jacobs;H17;10;23;52768972;54375509;1606537
Jacobs;H17;10;49;55944722;59143370;3198648
Jacobs;H17;10;17;67609179;68743197;1134018
Jacobs;H17;10;41;75314642;77276861;1962219
Jacobs;H17;10;50;82083004;84741018;2658014
Jacobs;H17;24;34;6265369;8224303;1958934
Jacobs;H17;24;31;17307132;19741398;2434266
Jacobs;H17;24;19;24776080;25961188;1185108
Jacobs;H17;24;23;28037384;29475441;1438057
Navajo-Churro;H2;2;31;45015658;46912545;1896887
Navajo-Churro;H2;2;439;60161996;84640849;24478853
Navajo-Churro;H2;2;18;103629915;104524885;894970
Navajo-Churro;H2;2;17;110228019;111172962;944943
Navajo-Churro;H2;2;20;113664053;115083516;1419463
Navajo-Churro;H2;2;99;220154626;225231192;5076566
Navajo-Churro;H2;2;74;230823473;235184763;4361290
Navajo-Churro;H2;2;18;235741975;236541718;799743
Navajo-Churro;H2;2;17;244212834;245030239;817405
Navajo-Churro;H2;10;107;73316053;78599973;5283920
Navajo-Churro;H2;24;18;32984246;33798780;814534
Navajo-Churro;H2;24;26;36962278;38459023;1496745
Navajo-Churro;H10;2;25;14359717;15424986;1065269
Navajo-Churro;H10;2;320;75848139;93890508;18042369
Navajo-Churro;H10;2;33;96439757;98682513;2242756
Navajo-Churro;H10;2;94;98817919;104016758;5198839
Navajo-Churro;H10;2;15;106521892;107171359;649467
Navajo-Churro;H10;2;17;108264568;108954373;689805
Navajo-Churro;H10;2;15;169129216;170000512;871296
Navajo-Churro;H10;2;17;199020889;199890020;869131
Navajo-Churro;H10;2;209;225312697;236562748;11250051
Navajo-Churro;H10;10;20;8564410;9608161;1043751
Navajo-Churro;H10;10;18;32465060;33582901;1117841
Navajo-Churro;H10;24;20;27739247;29155367;1416120
Navajo-Churro;H19;2;35;53837176;55493174;1655998
Navajo-Churro;H19;2;98;59972946;64886088;4913142
Navajo-Churro;H19;2;15;113113775;114558942;1445167
Navajo-Churro;H19;2;23;132289224;133229013;939789
Navajo-Churro;H19;2;17;147821995;148711192;889197
Navajo-Churro;H19;2;30;189470005;190978310;1508305
Navajo-Churro;H19;2;54;191910639;194853812;2943173
Navajo-Churro;H19;2;34;228977129;230789586;1812457
Navajo-Churro;H19;2;21;236027912;237315458;1287546
Navajo-Churro;H19;10;36;14237125;16338178;2101053
Navajo-Churro;H19;24;62;16351007;21554660;5203653
Navajo-Churro;H3;2;20;17073547;18001962;928415
Navajo-Churro;H3;2;15;54086367;54687816;601449
Navajo-Churro;H3;2;21;73828642;74945550;1116908
Navajo-Churro;H3;2;96;101388496;107325100;5936604
Navajo-Churro;H3;2;23;132289224;133229013;939789
Navajo-Churro;H3;2;65;158192547;162169519;3976972
Navajo-Churro;H3;2;19;204064678;205132747;1068069
Navajo-Churro;H3;10;27;31287916;32818994;1531078
Navajo-Churro;H3;10;26;62212986;64726524;2513538
Navajo-Churro;H3;10;15;74893559;75599218;705659
Navajo-Churro;H11;2;65;9266747;12558695;3291948
Navajo-Churro;H11;2;16;12636461;13571895;935434
Navajo-Churro;H11;2;41;85508894;87640092;2131198
Navajo-Churro;H11;2;16;184760567;185974821;1214254
Navajo-Churro;H11;2;30;189470005;190978310;1508305
Navajo-Churro;H11;10;24;36721436;38751668;2030232
Navajo-Churro;H11;10;15;40270353;40771431;501078
Navajo-Churro;H11;10;18;43417893;44519802;1101909
Navajo-Churro;H11;10;20;49560674;50876668;1315994
Navajo-Churro;H11;10;24;67307992;68743197;1435205
Navajo-Churro;H11;24;18;9658771;11366060;1707289
Navajo-Churro;H11;24;18;21836004;23312288;1476284
Navajo-Churro;H11;24;19;33313461;34113252;799791
Navajo-Churro;H11;24;15;34345815;35878194;1532379
Jacobs;H20;2;15;5940814;6740866;800052
Jacobs;H20;2;75;10782174;14827510;4045336
Jacobs;H20;2;31;38602691;40350901;1748210
Jacobs;H20;2;29;53415584;54744188;1328604
Jacobs;H20;2;74;58078003;61921092;3843089
Jacobs;H20;2;127;67597692;75042274;7444582
Jacobs;H20;2;104;75745623;80904183;5158560
Jacobs;H20;2;32;84640849;86380895;1740046
Jacobs;H20;2;22;91063757;92132718;1068961
Jacobs;H20;2;305;93217367;110875234;17657867
Jacobs;H20;2;71;110973427;117158936;6185509
Jacobs;H20;2;17;122060498;123432784;1372286
Jacobs;H20;2;35;133402369;135391568;1989199
Jacobs;H20;2;24;136745970;138081646;1335676
Jacobs;H20;2;15;165486783;166231789;745006
Jacobs;H20;2;115;180052852;187259707;7206855
Jacobs;H20;2;193;193176635;203989901;10813266
Jacobs;H20;2;50;216032030;220852308;4820278
Jacobs;H20;2;29;231170715;232688816;1518101
Jacobs;H20;2;27;247079021;248799264;1720243
Jacobs;H20;10;26;21584008;22955949;1371941
Jacobs;H20;10;141;25190096;32637918;7447822
Jacobs;H20;10;28;36883392;39457465;2574073
Jacobs;H20;10;16;52284660;53098812;814152
Jacobs;H20;10;52;67307992;70187303;2879311
Jacobs;H20;10;53;71426400;74592356;3165956
Jacobs;H20;10;47;74752408;77142109;2389701
Jacobs;H20;24;71;17996334;24060526;6064192
Jacobs;H20;24;17;24472703;25523363;1050660
Jacobs;H20;24;16;33780315;34666650;886335
Navajo-Churro;H4;2;25;14359717;15424986;1065269
Navajo-Churro;H4;2;18;88367759;89567061;1199302
Navajo-Churro;H4;2;15;110284541;111172962;888421
Navajo-Churro;H4;2;23;121607287;123362485;1755198
Navajo-Churro;H4;2;15;127390949;128292892;901943
Navajo-Churro;H4;2;16;178741258;179965972;1224714
Navajo-Churro;H4;10;20;8564410;9608161;1043751
Navajo-Churro;H4;24;20;27739247;29155367;1416120
Navajo-Churro;H12;2;80;25811615;31018254;5206639
Navajo-Churro;H12;2;308;67223689;84705740;17482051
Navajo-Churro;H12;2;419;95965733;122244312;26278579
Navajo-Churro;H12;2;82;123259113;127070041;3810928
Navajo-Churro;H12;2;30;189470005;190978310;1508305
Navajo-Churro;H12;2;54;191910639;194853812;2943173
Navajo-Churro;H12;10;15;32818994;33668510;849516
Navajo-Churro;H12;10;17;74728587;75599218;870631
Jacobs;H21;2;23;14914968;16096373;1181405
Jacobs;H21;2;16;18584559;19145768;561209
Jacobs;H21;2;18;39411236;40350901;939665
Jacobs;H21;2;33;42499181;44430836;1931655
Jacobs;H21;2;714;49169218;87916949;38747731
Jacobs;H21;2;29;91143985;92891269;1747284
Jacobs;H21;2;18;112551575;114279784;1728209
Jacobs;H21;2;21;121796989;123494681;1697692
Jacobs;H21;2;27;142863809;144457580;1593771
Jacobs;H21;2;21;155107453;156095039;987586
Jacobs;H21;2;15;158780390;159857007;1076617
Jacobs;H21;2;58;214020092;219694019;5673927
Jacobs;H21;2;18;220083076;221078667;995591
Jacobs;H21;2;50;226617529;229189424;2571895
Jacobs;H21;2;29;230789586;232414241;1624655
Jacobs;H21;2;48;233988816;236215993;2227177
Jacobs;H21;10;16;22768715;23642798;874083
Jacobs;H21;10;63;29947045;33296865;3349820
Jacobs;H21;10;33;33898953;35371668;1472715
Jacobs;H21;10;28;36883392;39457465;2574073
Jacobs;H21;10;19;40105937;40971187;865250
Jacobs;H21;10;17;46618259;47385192;766933
Jacobs;H21;10;17;50699349;51490237;790888
Jacobs;H21;10;82;55944722;60841810;4897088
Jacobs;H21;10;59;66779341;70187303;3407962
Jacobs;H21;10;182;71426400;81307769;9881369
Jacobs;H21;10;79;82225985;86415081;4189096
Jacobs;H21;24;22;7721963;8842899;1120936
Jacobs;H21;24;346;12065734;37808477;25742743
Jacobs;H13;2;184;39586061;51106073;11520012
Jacobs;H13;2;451;70802060;96566325;25764265
Jacobs;H13;2;444;100753683;127495017;26741334
Jacobs;H13;2;32;178456524;180818063;2361539
Jacobs;H13;2;48;211611196;215251657;3640461
Jacobs;H13;2;52;215844761;220852308;5007547
Jacobs;H13;2;28;229721318;231242200;1520882
Jacobs;H13;2;30;232260867;234119904;1859037
Jacobs;H13;2;15;235225978;235723972;497994
Jacobs;H13;10;35;1413129;3979769;2566640
Jacobs;H13;10;51;14736629;17481523;2744894
Jacobs;H13;10;264;29436435;45845544;16409109
Jacobs;H13;10;47;46618259;48804938;2186679
Jacobs;H13;10;18;53098812;54216568;1117756
Jacobs;H13;10;41;84297326;86415081;2117755
Jacobs;H13;24;68;16351007;21910840;5559833
Jacobs;H13;24;20;22329952;23828331;1498379
Jacobs;H22;2;64;1645676;4697573;3051897
Jacobs;H22;2;43;11728531;14016254;2287723
Jacobs;H22;2;16;14914968;15581003;666035
Jacobs;H22;2;16;23963448;24839164;875716
Jacobs;H22;2;110;25709378;32570209;6860831
Jacobs;H22;2;32;68216266;69880623;1664357
Jacobs;H22;2;30;79298450;80904183;1605733
Jacobs;H22;2;68;92213984;96209271;3995287
Jacobs;H22;2;74;101183181;105984105;4800924
Jacobs;H22;2;243;117115355;130206119;13090764
Jacobs;H22;2;19;130606432;131649580;1043148
Jacobs;H22;2;29;149539226;151148561;1609335
Jacobs;H22;2;25;176369323;178045098;1675775
Jacobs;H22;2;17;178676541;179939993;1263452
Jacobs;H22;2;76;180052852;184673171;4620319
Jacobs;H22;2;48;196397256;198928938;2531682
Jacobs;H22;2;15;199020889;199777656;756767
Jacobs;H22;2;70;211611196;217457102;5845906
Jacobs;H22;2;54;222606287;225193189;2586902
Jacobs;H22;2;29;231170715;232688816;1518101
Jacobs;H22;10;16;30072709;30849548;776839
Jacobs;H22;10;28;36883392;39457465;2574073
Jacobs;H22;10;29;42731359;45083665;2352306
Jacobs;H22;24;76;12722014;17996334;5274320
Jacobs;H22;24;76;36076909;42027686;5950777
Navajo-Churro;H6;2;48;64622544;67387676;2765132
Navajo-Churro;H6;2;17;80304321;80942245;637924
Navajo-Churro;H6;2;15;105984105;106716452;732347
Navajo-Churro;H6;2;59;117795421;121231306;3435885
Navajo-Churro;H6;2;21;241839716;243050370;1210654
Navajo-Churro;H6;10;20;23604001;24527613;923612
Navajo-Churro;H6;10;73;25827394;29806294;3978900
Navajo-Churro;H6;10;18;39026371;40071898;1045527
Navajo-Churro;H14;2;196;3603417;14159758;10556341
Navajo-Churro;H14;2;15;55995982;56751008;755026
Navajo-Churro;H14;2;19;107258684;107922518;663834
Navajo-Churro;H14;2;22;129537914;130831021;1293107
Navajo-Churro;H14;2;35;136336816;138159566;1822750
Navajo-Churro;H14;2;17;165941483;167111471;1169988
Navajo-Churro;H14;2;19;175418941;176765339;1346398
Navajo-Churro;H14;2;18;190937309;191673164;735855
Navajo-Churro;H14;2;21;193596846;194928608;1331762
Navajo-Churro;H14;10;21;29502667;30490110;987443
Navajo-Churro;H14;10;18;32465060;33582901;1117841
Navajo-Churro;H14;10;20;35885222;36883392;998170
Navajo-Churro;H14;10;26;43417893;44929212;1511319
Navajo-Churro;H14;10;144;54046513;63706057;9659544
Navajo-Churro;H14;24;21;21836004;23509895;1673891
Jacobs;H7;2;47;16416165;18878677;2462512
Jacobs;H7;2;31;18910726;20422624;1511898
Jacobs;H7;2;99;20514245;25709378;5195133
Jacobs;H7;2;60;30638836;33959555;3320719
Jacobs;H7;2;35;39411236;41597285;2186049
Jacobs;H7;2;29;53415584;54744188;1328604
Jacobs;H7;2;74;58078003;61921092;3843089
Jacobs;H7;2;127;67597692;75042274;7444582
Jacobs;H7;2;138;75745623;82706925;6961302
Jacobs;H7;2;38;84069275;86380895;2311620
Jacobs;H7;2;44;91063757;93513090;2449333
Jacobs;H7;2;164;117702396;126734704;9032308
Jacobs;H7;2;22;133402369;134770618;1368249
Jacobs;H7;2;97;134809036;140273577;5464541
Jacobs;H7;2;61;141007423;144457580;3450157
Jacobs;H7;2;89;199432096;203989901;4557805
Jacobs;H7;2;33;205305554;207231826;1926272
Jacobs;H7;2;26;216032030;219015064;2983034
Jacobs;H7;10;16;2277631;2953668;676037
Jacobs;H7;10;26;21584008;22955949;1371941
Jacobs;H7;10;103;25190096;30618253;5428157
Jacobs;H7;10;36;36847123;39942731;3095608
Jacobs;H7;10;16;52284660;53098812;814152
Jacobs;H7;10;53;71426400;74592356;3165956
Jacobs;H7;10;47;74752408;77142109;2389701
Jacobs;H7;24;29;11127323;13558686;2431363
Jacobs;H7;24;56;16351007;20918106;4567099
Jacobs;H7;24;17;40336394;42027686;1691292
Navajo-Churro;H15;2;189;14272947;24005033;9732086
Navajo-Churro;H15;2;15;53797807;54365821;568014
Navajo-Churro;H15;2;172;56413369;64886088;8472719
Navajo-Churro;H15;2;483;92162531;122244312;30081781
Navajo-Churro;H15;2;372;123259113;142902297;19643184
Navajo-Churro;H15;2;19;144500078;145444039;943961
Navajo-Churro;H15;2;93;243302892;248799264;5496372
Navajo-Churro;H15;10;35;42210604;44929212;2718608
Navajo-Churro;H15;10;272;52844259;70187303;17343044
Navajo-Churro;H15;10;128;71426400;78520137;7093737
Navajo-Churro;H15;10;31;82888777;84360979;1472202
Navajo-Churro;H15;24;16;25614223;26759068;1144845
Navajo-Churro;H24;2;16;46045582;47312229;1266647
Navajo-Churro;H24;2;19;144500078;145444039;943961
Navajo-Churro;H24;2;19;175418941;176765339;1346398
Navajo-Churro;H24;2;15;189470005;190239376;769371
Navajo-Churro;H24;2;19;242532287;243365308;833021
Navajo-Churro;H24;24;19;20442734;21878624;1435890
Navajo-Churro;H8;2;15;1426911;2157185;730274
Navajo-Churro;H8;2;15;80376822;80942245;565423
Navajo-Churro;H8;2;17;103778735;104876321;1097586
Navajo-Churro;H8;2;26;108235636;109487038;1251402
Navajo-Churro;H8;2;22;129537914;130831021;1293107
Navajo-Churro;H8;2;22;148479250;149505811;1026561
Navajo-Churro;H8;2;16;218592494;219933911;1341417
Navajo-Churro;H8;10;27;11027862;12600289;1572427
Navajo-Churro;H8;10;20;23604001;24527613;923612
Navajo-Churro;H8;10;73;25827394;29806294;3978900
Navajo-Churro;H8;10;18;39026371;40071898;1045527
Navajo-Churro;H8;24;58;5384735;8556294;3171559
Jacobs;H16;2;16;10266961;10887825;620864
Jacobs;H16;2;23;14914968;16096373;1181405
Jacobs;H16;2;16;18584559;19145768;561209
Jacobs;H16;2;35;39411236;41597285;2186049
Jacobs;H16;2;29;53415584;54744188;1328604
Jacobs;H16;2;74;58078003;61921092;3843089
Jacobs;H16;2;127;67597692;75042274;7444582
Jacobs;H16;2;138;75745623;82706925;6961302
Jacobs;H16;2;38;84069275;86380895;2311620
Jacobs;H16;2;44;91063757;93513090;2449333
Jacobs;H16;2;64;117702396;121330712;3628316
Jacobs;H16;2;16;122096448;123432784;1336336
Jacobs;H16;2;16;133402369;134244380;842011
Jacobs;H16;2;17;140158515;141007423;848908
Jacobs;H16;2;48;211611196;215251657;3640461
Jacobs;H16;2;52;215844761;220852308;5007547
Jacobs;H16;2;20;226617529;227734587;1117058
Jacobs;H16;2;23;231170715;232414241;1243526
Jacobs;H16;2;29;238940445;240477448;1537003
Jacobs;H16;10;16;2277631;2953668;676037
Jacobs;H16;10;20;21273163;22285343;1012180
Jacobs;H16;10;27;32773769;34079745;1305976
Jacobs;H16;10;173;34175819;45845544;11669725
Jacobs;H16;10;17;50699349;51490237;790888
Jacobs;H16;10;39;56546501;59143370;2596869
Jacobs;H16;10;88;71426400;76428043;5001643
Jacobs;H16;10;35;77939102;79746530;1807428
Jacobs;H16;24;17;5621749;6468168;846419
Jacobs;H16;24;69;16351007;22222030;5871023
Navajo-Churro;H25;2;25;9735180;10807181;1072001
Navajo-Churro;H25;2;26;21334859;22784701;1449842
Navajo-Churro;H25;2;22;34303557;35330121;1026564
Navajo-Churro;H25;2;39;52050037;54047306;1997269
Navajo-Churro;H25;2;17;80304321;80942245;637924
Navajo-Churro;H25;2;17;110228019;111172962;944943
Navajo-Churro;H25;2;17;209719454;210626872;907418
Navajo-Churro;H25;2;16;230439460;231340317;900857
Navajo-Churro;H25;10;47;25827394;28438915;2611521
Navajo-Churro;H25;10;33;28502457;30129111;1626654
Navajo-Churro;H25;10;15;32818994;33668510;849516
Navajo-Churro;H25;10;19;42731359;44495989;1764630
Navajo-Churro;H25;10;15;74681400;75468830;787430
Jacobs;H64;2;38;985851;2877210;1891359
Jacobs;H64;2;27;11979482;13473852;1494370
Jacobs;H64;2;21;25850068;27209958;1359890
Jacobs;H64;2;32;38506443;40269973;1763530
Jacobs;H64;2;16;53991275;54669270;677995
Jacobs;H64;2;81;70802060;75644823;4842763
Jacobs;H64;2;48;76843058;79120023;2276965
Jacobs;H64;2;135;80262318;87816239;7553921
Jacobs;H64;2;38;87879884;90395737;2515853
Jacobs;H64;2;15;94981400;95731895;750495
Jacobs;H64;2;21;96254860;97513382;1258522
Jacobs;H64;2;72;100147522;103910743;3763221
Jacobs;H64;2;25;131165894;132323750;1157856
Jacobs;H64;2;18;140104951;141007423;902472
Jacobs;H64;2;37;142250151;144457580;2207429
Jacobs;H64;2;40;165546958;167736523;2189565
Jacobs;H64;2;42;169088679;171585407;2496728
Jacobs;H64;2;27;198217868;199498132;1280264
Jacobs;H64;2;88;199606841;204064678;4457837
Jacobs;H64;2;51;211611196;215368972;3757776
Jacobs;H64;2;33;216032030;219694019;3661989
Jacobs;H64;2;37;241748973;244066362;2317389
Jacobs;H64;10;36;1413129;4075086;2661957
Jacobs;H64;10;49;5450092;9318987;3868895
Jacobs;H64;10;19;23068659;24187107;1118448
Jacobs;H64;10;126;25943893;32637918;6694025
Jacobs;H64;10;28;36883392;39457465;2574073
Jacobs;H64;10;27;83807586;85263429;1455843
Jacobs;H64;24;76;12722014;17996334;5274320
Jacobs;H64;24;25;33397677;34666650;1268973
Jacobs;H62;2;22;4835268;6003251;1167983
Jacobs;H62;2;27;8180894;9735180;1554286
Jacobs;H62;2;134;15581003;22664271;7083268
Jacobs;H62;2;72;67387676;71671999;4284323
Jacobs;H62;2;49;86164251;88553200;2388949
Jacobs;H62;2;47;131727936;133748186;2020250
Jacobs;H62;2;15;134667278;135391568;724290
Jacobs;H62;2;137;179521559;188204145;8682586
Jacobs;H62;10;65;15018558;18737350;3718792
Jacobs;H62;10;17;19096234;20012837;916603
Jacobs;H62;10;388;26003809;48804938;22801129
Jacobs;H62;10;44;75314642;77507372;2192730
Jacobs;H62;24;73;12181694;17307132;5125438
Jacobs;H62;24;16;24925070;25961188;1036118
Jacobs;H62;24;23;28037384;29475441;1438057
Navajo-Churro;H63;2;17;110228019;111172962;944943
Navajo-Churro;H63;10;15;15018558;16034194;1015636
Navajo-Churro;H63;10;16;37243595;39072962;1829367
Navajo-Churro;H63;24;16;26068027;27620251;1552224
Jacobs;H118;2;23;20046763;21080059;1033296
Jacobs;H118;2;16;32268777;33138364;869587
Jacobs;H118;2;18;35582012;36544130;962118
Jacobs;H118;2;99;51529698;56556228;5026530
Jacobs;H118;2;45;79017511;81273844;2256333
Jacobs;H118;2;53;83214641;86380895;3166254
Jacobs;H118;2;233;102804384;118180362;15375978
Jacobs;H118;2;15;122301320;123494681;1193361
Jacobs;H118;2;36;133402369;135446006;2043637
Jacobs;H118;2;45;140158515;142506224;2347709
Jacobs;H118;2;22;178119127;179673400;1554273
Jacobs;H118;2;32;187856073;189839836;1983763
Jacobs;H118;2;26;189930696;191228738;1298042
Jacobs;H118;2;24;199110298;200554450;1444152
Jacobs;H118;2;27;203942104;205403175;1461071
Jacobs;H118;2;18;211611196;212749665;1138469
Jacobs;H118;2;70;215774413;221534982;5760569
Jacobs;H118;2;71;222552458;226044848;3492390
Jacobs;H118;2;72;233461442;237221424;3759982
Jacobs;H118;10;41;5450092;8904686;3454594
Jacobs;H118;10;54;20540068;23445044;2904976
Jacobs;H118;10;401;29276560;52459290;23182730
Jacobs;H118;10;23;52768972;54375509;1606537
Jacobs;H118;10;30;68694545;70187303;1492758
Jacobs;H118;10;31;81173709;82687218;1513509
Jacobs;H118;24;15;26493858;27739247;1245389
Jacobs;H119;2;109;158066;6092514;5934448
Jacobs;H119;2;30;13307050;14827510;1520460
Jacobs;H119;2;73;15581003;19404154;3823151
Jacobs;H119;2;86;29409606;34303557;4893951
Jacobs;H119;2;82;40790032;45739882;4949850
Jacobs;H119;2;97;58791324;63837976;5046652
Jacobs;H119;2;173;65962375;76411172;10448797
Jacobs;H119;2;39;80376822;82013700;1636878
Jacobs;H119;2;17;122060498;123432784;1372286
Jacobs;H119;2;16;134194138;135063522;869384
Jacobs;H119;2;28;162689295;164188754;1499459
Jacobs;H119;2;15;232591652;233589543;997891
Jacobs;H119;2;30;241748973;243449101;1700128
Jacobs;H119;10;19;10108612;11027862;919250
Jacobs;H119;10;38;15018558;17138817;2120259
Jacobs;H119;10;145;23213276;30849548;7636272
Jacobs;H119;10;277;35566480;52388827;16822347
Jacobs;H119;10;21;55319894;56773821;1453927
Jacobs;H119;10;45;71426400;74261215;2834815
Jacobs;H119;10;20;77556267;78599973;1043706
Jacobs;H119;10;20;79416539;80465758;1049219
Jacobs;H119;10;31;82994149;84537988;1543839
Jacobs;H120;2;86;29409606;34303557;4893951
Jacobs;H120;2;82;40790032;45739882;4949850
Jacobs;H120;2;41;58791324;60993141;2201817
Jacobs;H120;2;55;61036097;63837976;2801879
Jacobs;H120;2;252;65962375;80343267;14380892
Jacobs;H120;2;36;81968762;84368094;2399332
Jacobs;H120;2;16;94981400;95965733;984333
Jacobs;H120;2;16;115340878;116108127;767249
Jacobs;H120;2;15;116784013;117464089;680076
Jacobs;H120;2;17;122060498;123432784;1372286
Jacobs;H120;2;20;128843993;129602869;758876
Jacobs;H120;2;37;131397735;132967710;1569975
Jacobs;H120;2;34;141007423;142709866;1702443
Jacobs;H120;2;28;162689295;164188754;1499459
Jacobs;H120;2;15;232591652;233589543;997891
Jacobs;H120;2;21;241748973;243005095;1256122
Jacobs;H120;2;20;246478010;247455331;977321
Jacobs;H120;10;100;1413129;8904686;7491557
Jacobs;H120;10;38;15018558;17138817;2120259
Jacobs;H120;10;145;23213276;30849548;7636272
Jacobs;H120;10;132;36353216;45845544;9492328
Jacobs;H120;10;21;55319894;56773821;1453927
Jacobs;H120;10;45;71426400;74261215;2834815
Jacobs;H120;10;20;77556267;78599973;1043706
Jacobs;H120;10;20;79416539;80465758;1049219
Jacobs;H121;2;15;4370486;5039528;669042
Jacobs;H121;2;19;6625835;7490500;864665
Jacobs;H121;2;51;19038121;21756019;2717898
Jacobs;H121;2;28;29960448;31388914;1428466
Jacobs;H121;2;26;49646230;51384849;1738619
Jacobs;H121;2;17;69626926;70721438;1094512
Jacobs;H121;2;30;79298450;80904183;1605733
Jacobs;H121;2;53;82507056;85956091;3449035
Jacobs;H121;2;40;88147512;90977972;2830460
Jacobs;H121;2;34;91063757;93102704;2038947
Jacobs;H121;2;27;93217367;94609125;1391758
Jacobs;H121;2;20;107171359;107911874;740515
Jacobs;H121;2;16;108309773;108954373;644600
Jacobs;H121;2;19;121796989;123432784;1635795
Jacobs;H121;2;16;131793590;132391474;597884
Jacobs;H121;2;23;136632758;137832529;1199771
Jacobs;H121;2;15;156555652;157252102;696450
Jacobs;H121;2;22;198495174;199498132;1002958
Jacobs;H121;2;26;200554450;201951137;1396687
Jacobs;H121;2;121;223908949;230323317;6414368
Jacobs;H121;2;15;235225978;235723972;497994
Jacobs;H121;10;133;29353089;36277638;6924549
Jacobs;H121;10;275;36353216;53005874;16652658
Jacobs;H121;10;45;71426400;74261215;2834815
Jacobs;H121;10;41;74924462;76973287;2048825
Jacobs;H121;10;39;77210348;79213622;2003274
Jacobs;H121;24;71;23828331;29155367;5327036
Jacobs;H122;2;75;985851;4697573;3711722
Jacobs;H122;2;24;14359717;15388156;1028439
Jacobs;H122;2;48;26664802;30026978;3362176
Jacobs;H122;2;63;54240741;57495366;3254625
Jacobs;H122;2;105;70548455;76783372;6234917
Jacobs;H122;2;38;84069275;86380895;2311620
Jacobs;H122;2;15;110083416;110941391;857975
Jacobs;H122;2;19;121796989;123432784;1635795
Jacobs;H122;2;24;127390949;128843993;1453044
Jacobs;H122;2;19;130606432;131649580;1043148
Jacobs;H122;2;21;132841528;133748186;906658
Jacobs;H122;2;16;215498705;217457102;1958397
Jacobs;H122;2;42;217890987;220955491;3064504
Jacobs;H122;2;45;221773273;224027318;2254045
Jacobs;H122;2;15;232591652;233589543;997891
Jacobs;H122;10;375;29353089;51490237;22137148
Jacobs;H122;10;21;51591083;52388827;797744
Jacobs;H122;10;26;53098812;54824597;1725785
Jacobs;H122;10;117;55075006;62050961;6975955
Jacobs;H122;10;21;63706057;65063529;1357472
Jacobs;H122;10;23;65269159;66264886;995727
Jacobs;H122;10;35;66447438;68575459;2128021
Jacobs;H122;10;109;71426400;77507372;6080972
Jacobs;H122;10;49;77939102;80465758;2526656
Jacobs;H122;10;18;80545891;81456858;910967
Jacobs;H122;10;22;81504664;82590071;1085407
Jacobs;H122;10;28;84100127;85627106;1526979
Jacobs;H122;24;45;5874652;8314969;2440317
Jacobs;H122;24;67;24106007;29155367;5049360
Jacobs;H123;2;15;56556228;57307599;751371
Jacobs;H123;2;17;114224745;115476148;1251403
Jacobs;H123;2;17;122060498;123432784;1372286
Jacobs;H123;2;65;151148561;155126465;3977904
Jacobs;H123;2;20;168933988;170000512;1066524
Jacobs;H123;2;33;208020229;209765359;1745130
Jacobs;H123;2;78;209830001;214228529;4398528
Jacobs;H123;2;16;215498705;217457102;1958397
Jacobs;H123;10;23;16338178;17481523;1143345
Jacobs;H123;10;17;31509560;32637918;1128358
Jacobs;H123;10;28;36883392;39457465;2574073
Jacobs;H123;10;18;40149974;40971187;821213
Jacobs;H123;10;32;47287047;48775457;1488410
Jacobs;H123;10;18;48900679;49680970;780291
Jacobs;H123;10;25;57351221;59236641;1885420
Jacobs;H123;10;35;59298205;61065661;1767456
Jacobs;H123;24;44;11076801;14492312;3415511
Jacobs;H124;2;45;16487040;18878677;2391637
Jacobs;H124;2;21;26100485;27311358;1210873
Jacobs;H124;2;47;49646230;52641482;2995252
Jacobs;H124;2;61;52714676;55758208;3043532
Jacobs;H124;2;31;55908488;57376604;1468116
Jacobs;H124;2;38;57495366;59112309;1616943
Jacobs;H124;2;33;80904183;82633584;1729401
Jacobs;H124;2;20;92213984;93451281;1237297
Jacobs;H124;2;26;94894157;96439757;1545600
Jacobs;H124;2;25;101985195;103407822;1422627
Jacobs;H124;2;32;116500683;118365256;1864573
Jacobs;H124;2;118;118497369;125164918;6667549
Jacobs;H124;2;36;125261082;126802631;1541549
Jacobs;H124;2;33;129537914;131584922;2047008
Jacobs;H124;2;20;131649580;132391474;741894
Jacobs;H124;2;33;142863809;144672338;1808529
Jacobs;H124;2;60;157252102;161172554;3920452
Jacobs;H124;2;30;161335278;162572509;1237231
Jacobs;H124;2;15;205305554;206180550;874996
Jacobs;H124;2;132;208232368;217457102;9224734
Jacobs;H124;2;34;238041313;239775862;1734549
Jacobs;H124;10;22;10577223;11853718;1276495
Jacobs;H124;10;27;16196817;17481523;1284706
Jacobs;H124;10;32;21682188;23289566;1607378
Jacobs;H124;10;62;25943893;29353089;3409196
Jacobs;H124;10;29;41802553;44171258;2368705
Jacobs;H124;10;18;48900679;49680970;780291
Jacobs;H124;10;21;51591083;52388827;797744
Jacobs;H124;10;23;52768972;54375509;1606537
Jacobs;H125;2;22;44760451;45959888;1199437
Jacobs;H125;2;17;73046724;73926990;880266
Jacobs;H125;2;41;84069275;86582074;2512799
Jacobs;H125;2;20;107171359;107911874;740515
Jacobs;H125;2;16;108309773;108954373;644600
Jacobs;H125;2;19;121796989;123432784;1635795
Jacobs;H125;2;24;149768329;151200968;1432639
Jacobs;H125;2;36;162689295;164516447;1827152
Jacobs;H125;2;27;189117884;190643587;1525703
Jacobs;H125;2;34;200160117;202088645;1928528
Jacobs;H125;2;40;219357404;221633575;2276171
Jacobs;H125;2;121;223908949;230323317;6414368
Jacobs;H125;10;100;1413129;8904686;7491557
Jacobs;H125;10;630;15018558;51490237;36471679
Jacobs;H125;10;114;51591083;58074623;6483540
Jacobs;H125;10;25;58143024;60035034;1892010
Jacobs;H125;10;45;71426400;74261215;2834815
Jacobs;H125;10;40;76069138;78140084;2070946
Jacobs;H125;10;43;84100127;86415081;2314954
Jacobs;H125;24;37;26493858;29343449;2849591
Jacobs;H125;24;18;30412150;31568788;1156638
Jacobs;H126;2;89;46598180;52218919;5620739
Jacobs;H126;2;18;53670410;54386685;716275
Jacobs;H126;2;70;80811295;84891847;4080552
Jacobs;H126;2;18;86266274;87138916;872642
Jacobs;H126;2;15;110083416;110941391;857975
Jacobs;H126;2;19;121796989;123432784;1635795
Jacobs;H126;2;34;133402369;135337045;1934676
Jacobs;H126;2;108;170058634;176450447;6391813
Jacobs;H126;2;85;186306661;191228738;4922077
Jacobs;H126;2;18;211611196;212749665;1138469
Jacobs;H126;2;22;213790888;215641893;1851005
Jacobs;H126;2;56;217890987;221534982;3643995
Jacobs;H126;2;33;222552458;224027318;1474860
Jacobs;H126;2;27;230439460;231931202;1491742
Jacobs;H126;10;49;10108612;13015377;2906765
Jacobs;H126;10;43;15018558;17388048;2369490
Jacobs;H126;10;22;22454477;23604001;1149524
Jacobs;H126;10;87;27989538;32391424;4401886
Jacobs;H126;10;18;36448017;37738237;1290220
Jacobs;H126;10;20;38727795;40071898;1344103
Jacobs;H126;10;30;68694545;70187303;1492758
Jacobs;H126;10;109;71426400;77507372;6080972
Jacobs;H126;10;65;77939102;81277340;3338238
Jacobs;H126;10;20;84100127;85263429;1163302
Jacobs;H126;24;40;29155367;31943864;2788497
Jacobs;H126;24;29;39603557;42027686;2424129
Jacobs;H127;2;30;4431496;5798140;1366644
Jacobs;H127;2;38;31712060;33959555;2247495
Jacobs;H127;2;16;45686718;46598180;911462
Jacobs;H127;2;45;54240741;56556228;2315487
Jacobs;H127;2;19;72875158;73926990;1051832
Jacobs;H127;2;30;79298450;80904183;1605733
Jacobs;H127;2;99;82507056;88172646;5665590
Jacobs;H127;2;20;107171359;107911874;740515
Jacobs;H127;2;16;108309773;108954373;644600
Jacobs;H127;2;19;121796989;123432784;1635795
Jacobs;H127;2;98;144342270;149720801;5378531
Jacobs;H127;2;108;170058634;176450447;6391813
Jacobs;H127;2;18;211611196;212749665;1138469
Jacobs;H127;2;22;213790888;215641893;1851005
Jacobs;H127;2;56;217890987;221534982;3643995
Jacobs;H127;2;33;222552458;224027318;1474860
Jacobs;H127;2;27;230439460;231931202;1491742
Jacobs;H127;2;27;238041313;239325418;1284105
Jacobs;H127;10;49;10108612;13015377;2906765
Jacobs;H127;10;43;15018558;17388048;2369490
Jacobs;H127;10;22;22454477;23604001;1149524
Jacobs;H127;10;95;27989538;32818994;4829456
Jacobs;H127;10;18;36448017;37738237;1290220
Jacobs;H127;10;20;38727795;40071898;1344103
Jacobs;H127;10;48;49876303;52388827;2512524
Jacobs;H127;10;30;68694545;70187303;1492758
Jacobs;H127;10;45;71426400;74261215;2834815
Jacobs;H127;10;35;82994149;84741018;1746869
Jacobs;H127;24;40;29155367;31943864;2788497
Jacobs;H127;24;24;39603557;41034970;1431413
Jacobs;H128;2;30;4431496;5798140;1366644
Jacobs;H128;2;38;31712060;33959555;2247495
Jacobs;H128;2;69;52266474;55758208;3491734
Jacobs;H128;2;70;55908488;59112309;3203821
Jacobs;H128;2;91;69626926;75042274;5415348
Jacobs;H128;2;112;75192672;80904183;5711511
Jacobs;H128;2;24;86266274;87415354;1149080
Jacobs;H128;2;15;110083416;110941391;857975
Jacobs;H128;2;16;122096448;123432784;1336336
Jacobs;H128;2;22;133402369;134770618;1368249
Jacobs;H128;2;20;168933988;170000512;1066524
Jacobs;H128;2;40;219357404;221633575;2276171
Jacobs;H128;2;96;223908949;229023952;5115003
Jacobs;H128;2;27;230439460;231931202;1491742
Jacobs;H128;2;44;238041313;240409281;2367968
Jacobs;H128;10;100;1413129;8904686;7491557
Jacobs;H128;10;43;15018558;17388048;2369490
Jacobs;H128;10;201;32773769;45845544;13071775
Jacobs;H128;10;39;52284660;54623451;2338791
Jacobs;H128;10;45;71426400;74261215;2834815
Jacobs;H128;10;35;82994149;84741018;1746869
Jacobs;H128;24;19;4116377;5433186;1316809
Jacobs;H128;24;80;25523363;31359697;5836334
Jacobs;H129;2;190;34376030;46219946;11843916
Jacobs;H129;2;16;53991275;54669270;677995
Jacobs;H129;2;15;56556228;57307599;751371
Jacobs;H129;2;1236;75799552;147821995;72022443
Jacobs;H129;2;367;148274554;169129216;20854662
Jacobs;H129;2;72;181909538;186224877;4315339
Jacobs;H129;2;16;215498705;217457102;1958397
Jacobs;H129;2;390;226569909;248799264;22229355
Jacobs;H129;10;40;24378713;26350351;1971638
Jacobs;H129;10;17;31509560;32637918;1128358
Jacobs;H129;10;132;36353216;45845544;9492328
Jacobs;H129;10;21;55319894;56773821;1453927
Jacobs;H129;10;165;60005994;70187303;10181309
Jacobs;H129;10;106;71426400;77276861;5850461
Jacobs;H129;10;43;82225985;84537988;2312003
Jacobs;H129;24;17;11076801;12387404;1310603
Jacobs;H129;24;41;19946691;23418622;3471931
Jacobs;H130;2;36;1248985;2877210;1628225
Jacobs;H130;2;79;54240741;58102980;3862239
Jacobs;H130;2;20;65402955;66543498;1140543
Jacobs;H130;2;18;66858417;67763382;904965
Jacobs;H130;2;30;75674121;77293547;1619426
Jacobs;H130;2;30;79298450;80904183;1605733
Jacobs;H130;2;99;82507056;88172646;5665590
Jacobs;H130;2;15;110083416;110941391;857975
Jacobs;H130;2;19;121796989;123432784;1635795
Jacobs;H130;2;34;133402369;135337045;1934676
Jacobs;H130;2;19;142863809;143918492;1054683
Jacobs;H130;2;24;162513140;163845372;1332232
Jacobs;H130;2;17;165399749;166231789;832040
Jacobs;H130;2;101;170563260;176450447;5887187
Jacobs;H130;2;18;211611196;212749665;1138469
Jacobs;H130;2;22;213790888;215641893;1851005
Jacobs;H130;2;45;218592494;221534982;2942488
Jacobs;H130;2;33;222552458;224027318;1474860
Jacobs;H130;2;83;225936196;230323317;4387121
Jacobs;H130;10;65;15018558;18737350;3718792
Jacobs;H130;10;17;19096234;20012837;916603
Jacobs;H130;10;201;32773769;45845544;13071775
Jacobs;H130;10;25;52284660;53838664;1554004
Jacobs;H130;10;45;71426400;74261215;2834815
Jacobs;H130;10;44;82994149;85263429;2269280
Jacobs;H130;24;40;29155367;31943864;2788497
Jacobs;H130;24;29;39603557;42027686;2424129
Jacobs;H131;2;16;10266961;10887825;620864
Jacobs;H131;2;57;31362675;34615665;3252990
Jacobs;H131;2;18;44538846;45357951;819105
Jacobs;H131;2;24;124443428;125352833;909405
Jacobs;H131;2;23;138618372;139800218;1181846
Jacobs;H131;2;15;139846639;140560157;713518
Jacobs;H131;2;36;184760567;187131720;2371153
Jacobs;H131;2;31;193318025;195245620;1927595
Jacobs;H131;2;20;195890936;197093416;1202480
Jacobs;H131;2;39;199432096;201797379;2365283
Jacobs;H131;2;48;211611196;215251657;3640461
Jacobs;H131;2;22;215844761;218418759;2573998
Jacobs;H131;2;30;241748973;243449101;1700128
Jacobs;H131;2;29;247005105;248799264;1794159
Jacobs;H131;10;67;29276560;32637918;3361358
Jacobs;H131;10;17;37182784;39072962;1890178
Jacobs;H131;10;18;40149974;40971187;821213
Jacobs;H131;10;21;47662790;48552870;890080
Jacobs;H131;10;35;82994149;84741018;1746869
Jacobs;H131;24;17;12550566;13767641;1217075
Jacobs;H131;24;25;32984246;34176391;1192145
Jacobs;H131;24;24;36425274;38125663;1700389
Jacobs;H132;2;170;26664802;36871168;10206366
Jacobs;H132;2;77;36971592;42499181;5527589
Jacobs;H132;2;409;54240741;76627899;22387158
Jacobs;H132;2;16;79000514;80032995;1032481
Jacobs;H132;2;38;84069275;86380895;2311620
Jacobs;H132;2;16;115340878;116108127;767249
Jacobs;H132;2;15;116784013;117464089;680076
Jacobs;H132;2;17;122060498;123432784;1372286
Jacobs;H132;2;37;126802631;128843993;2041362
Jacobs;H132;2;19;130606432;131649580;1043148
Jacobs;H132;2;21;132841528;133748186;906658
Jacobs;H132;2;28;162689295;164188754;1499459
Jacobs;H132;2;33;204702992;206382108;1679116
Jacobs;H132;2;95;207575434;212749665;5174231
Jacobs;H132;2;37;213505877;217457102;3951225
Jacobs;H132;2;15;220083076;220955491;872415
Jacobs;H132;10;83;10202679;14924805;4722126
Jacobs;H132;10;27;32818994;34175819;1356825
Jacobs;H132;10;16;36637311;37738237;1100926
Jacobs;H132;10;31;41802553;44430609;2628056
Jacobs;H132;10;72;74131332;77844952;3713620
Jacobs;H132;24;43;96467;3580800;3484333
Jacobs;H132;24;15;15637488;16892562;1255074
Jacobs;H132;24;16;31556086;32390507;834421
Jacobs;H133;2;56;158066;3489649;3331583
Jacobs;H133;2;182;15281005;24839164;9558159
Jacobs;H133;2;66;45658202;49646230;3988028
Jacobs;H133;2;32;51824098;53366034;1541936
Jacobs;H133;2;58;68216266;71671999;3455733
Jacobs;H133;2;56;95731895;99427585;3695690
Jacobs;H133;2;21;114411448;115743360;1331912
Jacobs;H133;2;15;116108127;117115355;1007228
Jacobs;H133;2;39;133402369;135536214;2133845
Jacobs;H133;2;70;140104951;143918492;3813541
Jacobs;H133;2;39;147759341;149609364;1850023
Jacobs;H133;2;161;179799000;189839836;10040836
Jacobs;H133;2;60;189930696;192989350;3058654
Jacobs;H133;2;55;193433380;197093416;3660036
Jacobs;H133;2;134;207040648;215251657;8211009
Jacobs;H133;2;35;215844761;219694019;3849258
Jacobs;H133;2;18;220083076;221078667;995591
Jacobs;H133;10;40;14573661;16929716;2356055
Jacobs;H133;10;18;36448017;37738237;1290220
Jacobs;H133;10;20;38727795;40071898;1344103
Jacobs;H133;24;20;11127323;12722014;1594691
Jacobs;H133;24;68;27928201;32390507;4462306
Jacobs;H133;24;20;33313461;34176391;862930
Jacobs;H133;24;72;36425274;42027686;5602412
Jacobs;H134;2;25;25563222;27209958;1646736
Jacobs;H134;2;16;53991275;54669270;677995
Jacobs;H134;2;105;70548455;76783372;6234917
Jacobs;H134;2;16;94981400;95965733;984333
Jacobs;H134;2;16;115340878;116108127;767249
Jacobs;H134;2;15;116784013;117464089;680076
Jacobs;H134;2;17;122060498;123432784;1372286
Jacobs;H134;2;84;128843993;132967710;4123717
Jacobs;H134;2;22;171171929;172311083;1139154
Jacobs;H134;2;602;179521559;214228529;34706970
Jacobs;H134;2;16;215498705;217457102;1958397
Jacobs;H134;2;15;220083076;220955491;872415
Jacobs;H134;2;29;238940445;240477448;1537003
Jacobs;H134;10;103;16338178;22285343;5947165
Jacobs;H134;10;31;41802553;44430609;2628056
Jacobs;H134;10;28;48397749;49680970;1283221
Jacobs;H134;10;16;67609179;68694545;1085366
Jacobs;H134;10;21;84029946;85263429;1233483
Jacobs;H134;24;23;203039;2191707;1988668
Jacobs;H134;24;34;26493858;29155367;2661509
Jacobs;H135;2;45;54240741;56556228;2315487
Jacobs;H135;2;39;80376822;82013700;1636878
Jacobs;H135;2;21;84580673;85875802;1295129
Jacobs;H135;2;17;100951258;101600940;649682
Jacobs;H135;2;18;116203332;117295185;1091853
Jacobs;H135;2;19;122060498;123494681;1434183
Jacobs;H135;2;15;135590631;136512593;921962
Jacobs;H135;2;40;147759341;149666645;1907304
Jacobs;H135;2;65;151148561;155126465;3977904
Jacobs;H135;2;39;172699752;175124550;2424798
Jacobs;H135;2;70;199432096;203129937;3697841
Jacobs;H135;2;44;203219228;205454966;2235738
Jacobs;H135;10;25;6551668;8904686;2353018
Jacobs;H135;10;16;18930071;19700851;770780
Jacobs;H135;10;195;22376804;32637918;10261114
Jacobs;H135;10;38;36883392;40071898;3188506
Jacobs;H135;10;116;40149974;47487991;7338017
Jacobs;H135;10;39;47662790;49310196;1647406
Jacobs;H135;10;78;73436454;77142109;3705655
Jacobs;H135;24;24;5232180;6526499;1294319
Jacobs;H135;24;72;11076801;16077497;5000696
Jacobs;H135;24;75;18056244;24493823;6437579
Jacobs;H135;24;61;31953567;36076909;4123342
Jacobs;H136;2;541;158066;30485387;30327321
Jacobs;H136;2;555;30589213;62416830;31827617
Jacobs;H136;2;17;91333600;92162531;828931
Jacobs;H136;2;44;99302002;101521231;2219229
Jacobs;H136;2;24;113897647;115665643;1767996
Jacobs;H136;2;17;122060498;123432784;1372286
Jacobs;H136;2;65;151148561;155126465;3977904
Jacobs;H136;2;72;181909538;186224877;4315339
Jacobs;H136;2;84;244066362;248799264;4732902
Jacobs;H136;10;116;1413129;9736034;8322905
Jacobs;H136;10;66;10922307;14856146;3933839
Jacobs;H136;10;20;21309973;22376804;1066831
Jacobs;H136;10;17;31509560;32637918;1128358
Jacobs;H136;10;146;35566480;45845544;10279064
Jacobs;H136;10;21;55319894;56773821;1453927
Jacobs;H136;10;165;60005994;70187303;10181309
Jacobs;H136;10;128;71426400;78520137;7093737
Jacobs;H136;10;150;78803876;86415081;7611205
Jacobs;H136;24;19;2043961;3446498;1402537
Jacobs;H137;2;36;2451471;4166902;1715431
Jacobs;H137;2;25;25563222;27209958;1646736
Jacobs;H137;2;16;53991275;54669270;677995
Jacobs;H137;2;105;70548455;76783372;6234917
Jacobs;H137;2;27;82692589;84368094;1675505
Jacobs;H137;2;16;94981400;95965733;984333
Jacobs;H137;2;16;115340878;116108127;767249
Jacobs;H137;2;15;116784013;117464089;680076
Jacobs;H137;2;17;122060498;123432784;1372286
Jacobs;H137;2;84;128843993;132967710;4123717
Jacobs;H137;2;18;137024724;138081646;1056922
Jacobs;H137;2;37;141766599;143918492;2151893
Jacobs;H137;2;139;155064316;163070840;8006524
Jacobs;H137;2;606;182923305;219847222;36923917
Jacobs;H137;2;32;225936196;227734587;1798391
Jacobs;H137;2;15;232591652;233589543;997891
Jacobs;H137;2;30;241748973;243449101;1700128
Jacobs;H137;10;18;36448017;37738237;1290220
Jacobs;H137;10;20;38727795;40071898;1344103
Jacobs;H137;10;38;48397749;50290499;1892750
Jacobs;H137;10;18;53098812;54216568;1117756
Jacobs;H137;10;103;71426400;77142109;5715709
Jacobs;H137;24;69;26493858;31568788;5074930
Jacobs;H138;2;50;2451471;4697573;2246102
Jacobs;H138;2;525;24839164;56556228;31717064
Jacobs;H138;2;19;121796989;123432784;1635795
Jacobs;H138;2;49;127699622;130206119;2506497
Jacobs;H138;2;34;133402369;135337045;1934676
Jacobs;H138;2;18;141766599;142709866;943267
Jacobs;H138;2;33;208020229;209765359;1745130
Jacobs;H138;2;78;209830001;214228529;4398528
Jacobs;H138;2;23;233775867;235161178;1385311
Jacobs;H138;10;17;18707689;19637375;929686
Jacobs;H138;10;24;21682188;22955949;1273761
Jacobs;H138;10;68;29353089;32818994;3465905
Jacobs;H138;10;31;41802553;44430609;2628056
Jacobs;H138;10;48;49876303;52388827;2512524
Jacobs;H138;10;35;57261965;59691651;2429686
Jacobs;H138;10;21;84029946;85263429;1233483
Jacobs;H138;24;55;5874652;8842899;2968247
Jacobs;H139;2;17;24646366;25359294;712928
Jacobs;H139;2;26;49646230;51384849;1738619
Jacobs;H139;2;20;65402955;66543498;1140543
Jacobs;H139;2;18;66858417;67763382;904965
Jacobs;H139;2;52;84069275;87138916;3069641
Jacobs;H139;2;15;110083416;110941391;857975
Jacobs;H139;2;19;121796989;123432784;1635795
Jacobs;H139;2;46;132841528;135337045;2495517
Jacobs;H139;2;24;149768329;151200968;1432639
Jacobs;H139;2;15;158290735;159437585;1146850
Jacobs;H139;2;70;187856073;191673164;3817091
Jacobs;H139;2;15;203751286;204502491;751205
Jacobs;H139;2;26;205305554;206821701;1516147
Jacobs;H139;2;18;211611196;212749665;1138469
Jacobs;H139;2;22;213790888;215641893;1851005
Jacobs;H139;2;56;217890987;221534982;3643995
Jacobs;H139;2;33;222552458;224027318;1474860
Jacobs;H139;2;83;225936196;230323317;4387121
Jacobs;H139;10;100;1413129;8904686;7491557
Jacobs;H139;10;43;15018558;17388048;2369490
Jacobs;H139;10;201;32773769;45845544;13071775
Jacobs;H139;10;34;52284660;54375509;2090849
Jacobs;H139;10;32;74131332;75682529;1551197
Jacobs;H139;24;37;26493858;29343449;2849591
Jacobs;H139;24;31;29475441;31568788;2093347
Jacobs;H140;2;18;9735180;10487132;751952
Jacobs;H140;2;16;45150277;46163449;1013172
Jacobs;H140;2;27;47352919;49009193;1656274
Jacobs;H140;2;26;49646230;51384849;1738619
Jacobs;H140;2;28;68055389;69441272;1385883
Jacobs;H140;2;114;75674121;81377249;5703128
Jacobs;H140;2;26;81452694;82891061;1438367
Jacobs;H140;2;22;83090209;84368094;1277885
Jacobs;H140;2;51;94981400;98156393;3174993
Jacobs;H140;2;89;103049092;107989499;4940407
Jacobs;H140;2;130;108736660;118365256;9628596
Jacobs;H140;2;132;119388364;126384559;6996195
Jacobs;H140;2;25;140827873;142063966;1236093
Jacobs;H140;2;44;142192657;144672338;2479681
Jacobs;H140;2;18;211611196;212749665;1138469
Jacobs;H140;2;22;213790888;215641893;1851005
Jacobs;H140;2;59;217890987;221633575;3742588
Jacobs;H140;2;45;221773273;224027318;2254045
Jacobs;H140;2;15;232591652;233589543;997891
Jacobs;H140;2;22;247548978;248799264;1250286
Jacobs;H140;10;15;1413129;2796718;1383589
Jacobs;H140;10;16;6883264;8495362;1612098
Jacobs;H140;10;33;32773769;34386151;1612382
Jacobs;H140;10;28;36883392;39457465;2574073
Jacobs;H140;10;18;46618259;47487991;869732
Jacobs;H140;10;23;60005994;61065661;1059667
Jacobs;H140;10;20;75314642;76300586;985944
Jacobs;H140;24;73;12181694;17307132;5125438
Jacobs;H141;2;26;6349125;7973431;1624306
Jacobs;H141;2;17;10782174;11555842;773668
Jacobs;H141;2;35;12988767;14827510;1838743
Jacobs;H141;2;48;26664802;30026978;3362176
Jacobs;H141;2;16;45150277;46163449;1013172
Jacobs;H141;2;30;46833373;49009193;2175820
Jacobs;H141;2;26;49646230;51384849;1738619
Jacobs;H141;2;25;55160910;56556228;1395318
Jacobs;H141;2;209;87177434;99808715;12631281
Jacobs;H141;2;142;99887361;107989499;8102138
Jacobs;H141;2;334;108072803;128843993;20771190
Jacobs;H141;2;34;133402369;135337045;1934676
Jacobs;H141;2;60;152529090;156095039;3565949
Jacobs;H141;2;20;176450447;177920217;1469770
Jacobs;H141;2;194;187856073;199020889;11164816
Jacobs;H141;2;45;238041313;240477448;2436135
Jacobs;H141;2;22;247548978;248799264;1250286
Jacobs;H141;10;15;1413129;2796718;1383589
Jacobs;H141;10;16;6883264;8495362;1612098
Jacobs;H141;10;33;32773769;34386151;1612382
Jacobs;H141;10;28;36883392;39457465;2574073
Jacobs;H141;10;18;46618259;47487991;869732
Jacobs;H141;10;57;66264886;69596499;3331613
Jacobs;H141;10;29;74131332;75564317;1432985
Jacobs;H141;10;15;77234571;78093080;858509
Jacobs;H141;10;34;84696261;86415081;1718820
Jacobs;H141;24;36;29155367;31568788;2413421
Jacobs;H142;2;50;2451471;4697573;2246102
Jacobs;H142;2;28;24839164;26315932;1476768
Jacobs;H142;2;16;29409606;30280645;871039
Jacobs;H142;2;105;70548455;76783372;6234917
Jacobs;H142;2;20;122060498;123528595;1468097
Jacobs;H142;2;19;130606432;131649580;1043148
Jacobs;H142;2;25;149720801;151200968;1480167
Jacobs;H142;2;20;168933988;170000512;1066524
Jacobs;H142;2;335;172917684;193433380;20515696
Jacobs;H142;2;112;208020229;214228529;6208300
Jacobs;H142;2;29;238940445;240477448;1537003
Jacobs;H142;10;103;16338178;22285343;5947165
Jacobs;H142;10;18;36448017;37738237;1290220
Jacobs;H142;10;20;38727795;40071898;1344103
Jacobs;H142;10;38;48397749;50290499;1892750
Jacobs;H142;10;33;52284660;54216568;1931908
Jacobs;H142;10;40;56914955;59691651;2776696
Jacobs;H142;10;25;68944509;70187303;1242794
Jacobs;H142;10;45;71426400;74261215;2834815
Jacobs;H142;10;20;77556267;78599973;1043706
Jacobs;H142;10;20;79416539;80465758;1049219
Jacobs;H142;24;34;26493858;29155367;2661509
Jacobs;H143;2;20;19163821;20209570;1045749
Jacobs;H143;2;29;26100485;27784609;1684124
Jacobs;H143;2;17;65962375;67012655;1050280
Jacobs;H143;2;35;67625735;69441272;1815537
Jacobs;H143;2;87;116500683;121330712;4830029
Jacobs;H143;2;100;121455578;126802631;5347053
Jacobs;H143;2;54;129537914;132391474;2853560
Jacobs;H143;2;33;142863809;144672338;1808529
Jacobs;H143;2;275;157252102;172917684;15665582
Jacobs;H143;2;25;180080977;181909538;1828561
Jacobs;H143;2;30;215498705;218309332;2810627
Jacobs;H143;2;54;219933911;222800960;2867049
Jacobs;H143;10;27;16196817;17481523;1284706
Jacobs;H143;10;32;21682188;23289566;1607378
Jacobs;H143;10;62;25943893;29353089;3409196
Jacobs;H143;10;31;41802553;44430609;2628056
Jacobs;H143;10;28;48397749;49680970;1283221
Jacobs;H143;10;57;66264886;69596499;3331613
Jacobs;H143;10;66;74131332;77411116;3279784
Jacobs;H143;10;35;82994149;84741018;1746869
Jacobs;H143;24;17;26493858;28037384;1543526
Jacobs;H143;24;16;28178738;29155367;976629
Jacobs;H144;2;41;2451471;4351718;1900247
Jacobs;H144;2;45;54240741;56556228;2315487
Jacobs;H144;2;93;75626143;80343267;4717124
Jacobs;H144;2;74;85661724;89810015;4148291
Jacobs;H144;2;20;122060498;123528595;1468097
Jacobs;H144;2;38;125343919;127088467;1744548
Jacobs;H144;2;31;129353026;131064734;1711708
Jacobs;H144;2;40;131165894;132967710;1801816
Jacobs;H144;2;50;144088879;146734798;2645919
Jacobs;H144;2;139;155064316;163070840;8006524
Jacobs;H144;2;20;168933988;170000512;1066524
Jacobs;H144;2;43;215680487;219847222;4166735
Jacobs;H144;2;135;231170715;238675170;7504455
Jacobs;H144;10;131;14813653;22376804;7563151
Jacobs;H144;10;124;31509560;39457465;7947905
Jacobs;H144;10;19;40105937;40971187;865250
Jacobs;H144;10;39;47662790;49310196;1647406
Jacobs;H144;10;78;73436454;77142109;3705655
Jacobs;H144;24;43;96467;3580800;3484333
Jacobs;H145;2;41;2451471;4351718;1900247
Jacobs;H145;2;32;13507694;15035660;1527966
Jacobs;H145;2;61;16374818;19404154;3029336
Jacobs;H145;2;38;46219946;48824104;2604158
Jacobs;H145;2;30;60161996;61875935;1713939
Jacobs;H145;2;72;62820094;66543498;3723404
Jacobs;H145;2;32;69626926;71671999;2045073
Jacobs;H145;2;23;87394092;88447935;1053843
Jacobs;H145;2;15;108736660;109420304;683644
Jacobs;H145;2;21;116265153;117413762;1148609
Jacobs;H145;2;57;124171406;126734704;2563298
Jacobs;H145;2;22;127699622;128843993;1144371
Jacobs;H145;2;47;132841528;135391568;2550040
Jacobs;H145;2;24;136745970;138081646;1335676
Jacobs;H145;2;50;140158515;142709866;2551351
Jacobs;H145;2;22;215309338;217457102;2147764
Jacobs;H145;2;17;236347543;237488816;1141273
Jacobs;H145;10;34;1413129;3881451;2468322
Jacobs;H145;10;41;14523808;16929716;2405908
Jacobs;H145;10;22;22454477;23604001;1149524
Jacobs;H145;10;95;27989538;32818994;4829456
Jacobs;H145;10;18;36448017;37738237;1290220
Jacobs;H145;10;20;38727795;40071898;1344103
Jacobs;H145;10;48;49876303;52388827;2512524
Jacobs;H145;10;17;71426400;72848051;1421651
Jacobs;H145;10;78;74131332;78140084;4008752
Jacobs;H145;10;41;78803876;80865534;2061658
Jacobs;H145;10;36;84620983;86415081;1794098
Jacobs;H145;24;17;96467;1377045;1280578
Jacobs;H146;2;41;2451471;4351718;1900247
Jacobs;H146;2;69;5094572;9266747;4172175
Jacobs;H146;2;255;16374818;30785949;14411131
Jacobs;H146;2;28;46833373;48824104;1990731
Jacobs;H146;2;74;51143878;54936988;3793110
Jacobs;H146;2;71;85242819;88789712;3546893
Jacobs;H146;2;63;95731895;99808715;4076820
Jacobs;H146;2;50;124171406;126384559;2213153
Jacobs;H146;2;47;132841528;135391568;2550040
Jacobs;H146;2;20;136745970;137781188;1035218
Jacobs;H146;2;26;157574569;159389044;1814475
Jacobs;H146;2;215;159513893;171398254;11884361
Jacobs;H146;2;56;184565642;188204145;3638503
Jacobs;H146;2;104;193433380;199626176;6192796
Jacobs;H146;2;134;207040648;215251657;8211009
Jacobs;H146;2;52;215844761;220852308;5007547
Jacobs;H146;2;23;247498052;248799264;1301212
Jacobs;H146;10;15;14007878;14736629;728751
Jacobs;H146;10;44;18737350;21363789;2626439
Jacobs;H146;10;30;21927581;23604001;1676420
Jacobs;H146;10;270;31732075;48552870;16820795
Jacobs;H146;10;15;51140627;51707941;567314
Jacobs;H146;24;62;96467;5075204;4978737
Jacobs;H146;24;82;5621749;10802789;5181040
Jacobs;H146;24;22;11007102;12722014;1714912
Jacobs;H147;2;219;158066;12492887;12334821
Jacobs;H147;2;40;12988767;15035660;2046893
Jacobs;H147;2;15;16487040;17140743;653703
Jacobs;H147;2;58;36971592;40931803;3960211
Jacobs;H147;2;18;53670410;54386685;716275
Jacobs;H147;2;47;55908488;57989729;2081241
Jacobs;H147;2;180;58102980;67597692;9494712
Jacobs;H147;2;1102;67676280;132391474;64715194
Jacobs;H147;2;33;142863809;144672338;1808529
Jacobs;H147;2;59;167249075;170471855;3222780
Jacobs;H147;2;315;201153924;220955491;19801567
Jacobs;H147;2;89;243537018;248799264;5262246
Jacobs;H147;10;28;36883392;39457465;2574073
Jacobs;H147;10;18;40149974;40971187;821213
Jacobs;H147;10;18;46618259;47487991;869732
Jacobs;H147;10;28;51591083;52630202;1039119
Jacobs;H147;10;23;52768972;54375509;1606537
Jacobs;H147;10;43;84100127;86415081;2314954
Jacobs;H147;24;15;15367865;16310285;942420
Jacobs;H147;24;15;20395301;21460746;1065445
Jacobs;H147;24;36;29155367;31568788;2413421
Jacobs;H148;2;40;12988767;15035660;2046893
Jacobs;H148;2;15;16487040;17140743;653703
Jacobs;H148;2;375;34985894;57376604;22390710
Jacobs;H148;2;298;57495366;73598907;16103541
Jacobs;H148;2;52;84069275;87138916;3069641
Jacobs;H148;2;17;117702396;119081713;1379317
Jacobs;H148;2;19;121796989;123432784;1635795
Jacobs;H148;2;34;133402369;135337045;1934676
Jacobs;H148;2;61;148597613;151888029;3290416
Jacobs;H148;2;108;170058634;176450447;6391813
Jacobs;H148;2;18;211611196;212749665;1138469
Jacobs;H148;2;22;213790888;215641893;1851005
Jacobs;H148;2;22;215844761;218418759;2573998
Jacobs;H148;2;15;220083076;220955491;872415
Jacobs;H148;10;100;1413129;8904686;7491557
Jacobs;H148;10;342;15018558;33898953;18880395
Jacobs;H148;10;18;36448017;37738237;1290220
Jacobs;H148;10;20;38727795;40071898;1344103
Jacobs;H148;10;26;49876303;51490237;1613934
Jacobs;H148;10;21;51591083;52388827;797744
Jacobs;H148;10;184;71426400;81456858;10030458
Jacobs;H148;10;96;81504664;86415081;4910417
Jacobs;H148;24;40;29155367;31943864;2788497
Jacobs;H148;24;24;39603557;41034970;1431413
Jacobs;H149;2;109;158066;6092514;5934448
Jacobs;H149;2;30;13307050;14827510;1520460
Jacobs;H149;2;15;16487040;17140743;653703
Jacobs;H149;2;48;26664802;30026978;3362176
Jacobs;H149;2;82;40790032;45739882;4949850
Jacobs;H149;2;88;58791324;63479215;4687891
Jacobs;H149;2;17;65962375;67012655;1050280
Jacobs;H149;2;35;67625735;69441272;1815537
Jacobs;H149;2;39;80376822;82013700;1636878
Jacobs;H149;2;28;131397735;132608113;1210378
Jacobs;H149;2;34;141007423;142709866;1702443
Jacobs;H149;10;201;32773769;45845544;13071775
Jacobs;H149;10;15;55319894;56430010;1110116
Jacobs;H149;10;45;71426400;74261215;2834815
Jacobs;H149;10;20;77556267;78599973;1043706
Jacobs;H149;10;20;79416539;80465758;1049219
Jacobs;H150;2;86;29409606;34303557;4893951
Jacobs;H150;2;82;40790032;45739882;4949850
Jacobs;H150;2;25;58791324;60044110;1252786
Jacobs;H150;2;17;65962375;67012655;1050280
Jacobs;H150;2;35;67625735;69441272;1815537
Jacobs;H150;2;39;80376822;82013700;1636878
Jacobs;H150;2;16;94981400;95965733;984333
Jacobs;H150;2;16;115340878;116108127;767249
Jacobs;H150;2;15;116784013;117464089;680076
Jacobs;H150;2;17;122060498;123432784;1372286
Jacobs;H150;2;84;128843993;132967710;4123717
Jacobs;H150;2;34;141007423;142709866;1702443
Jacobs;H150;2;15;232591652;233589543;997891
Jacobs;H150;2;30;241748973;243449101;1700128
Jacobs;H150;10;100;1413129;8904686;7491557
Jacobs;H150;10;38;15018558;17138817;2120259
Jacobs;H150;10;145;23213276;30849548;7636272
Jacobs;H150;10;18;36448017;37738237;1290220
Jacobs;H150;10;20;38727795;40071898;1344103
Jacobs;H150;10;48;49876303;52388827;2512524
Jacobs;H150;10;35;68339290;70187303;1848013
Jacobs;H150;10;103;71426400;77142109;5715709
Jacobs;H150;24;16;34607110;36160755;1553645
Jacobs;H151;2;59;11555842;14827510;3271668
Jacobs;H151;2;251;16622194;30785949;14163755
Jacobs;H151;2;45;40350901;43558237;3207336
Jacobs;H151;2;28;46833373;48824104;1990731
Jacobs;H151;2;32;51824098;53366034;1541936
Jacobs;H151;2;21;114411448;115743360;1331912
Jacobs;H151;2;15;116108127;117115355;1007228
Jacobs;H151;2;47;132841528;135391568;2550040
Jacobs;H151;2;24;136745970;138081646;1335676
Jacobs;H151;2;50;140158515;142709866;2551351
Jacobs;H151;2;39;147759341;149609364;1850023
Jacobs;H151;2;222;179799000;192989350;13190350
Jacobs;H151;2;47;196829899;199225518;2395619
Jacobs;H151;2;18;210948623;211695755;747132
Jacobs;H151;10;78;17748924;22285343;4536419
Jacobs;H151;10;67;29276560;32637918;3361358
Jacobs;H151;10;36;36847123;39942731;3095608
Jacobs;H151;10;30;41210470;43778374;2567904
Jacobs;H151;10;27;47287047;48552870;1265823
Jacobs;H151;24;25;8460459;9942134;1481675
Jacobs;H151;24;43;23209530;26142394;2932864
Jacobs;H152;2;16;45686718;46598180;911462
Jacobs;H152;2;45;54240741;56556228;2315487
Jacobs;H152;2;70;80811295;84891847;4080552
Jacobs;H152;2;18;86266274;87138916;872642
Jacobs;H152;2;76;117702396;122001925;4299529
Jacobs;H152;2;87;122096448;126734704;4638256
Jacobs;H152;2;34;133402369;135337045;1934676
Jacobs;H152;2;36;162689295;164516447;1827152
Jacobs;H152;2;15;220083076;220955491;872415
Jacobs;H152;2;47;240684120;243365308;2681188
Jacobs;H152;10;100;1413129;8904686;7491557
Jacobs;H152;10;747;15018558;58143024;43124466
Jacobs;H152;10;109;71426400;77507372;6080972
Jacobs;H152;10;65;77939102;81277340;3338238
Jacobs;H152;10;20;84100127;85263429;1163302
Jacobs;H152;24;45;17642594;21460746;3818152
Jacobs;H152;24;34;29155367;31359697;2204330
Jacobs;H153;2;103;16622194;21883834;5261640
Jacobs;H153;2;27;22809937;24092677;1282740
Jacobs;H153;2;18;24839164;25709378;870214
Jacobs;H153;2;18;39411236;40350901;939665
Jacobs;H153;2;28;46833373;48824104;1990731
Jacobs;H153;2;147;77200457;85150906;7950449
Jacobs;H153;2;28;98008059;99808715;1800656
Jacobs;H153;2;20;107171359;107911874;740515
Jacobs;H153;2;16;108309773;108954373;644600
Jacobs;H153;2;19;121796989;123432784;1635795
Jacobs;H153;2;118;131649580;137781188;6131608
Jacobs;H153;2;33;142863809;144672338;1808529
Jacobs;H153;2;60;152529090;156095039;3565949
Jacobs;H153;2;56;184565642;188204145;3638503
Jacobs;H153;2;18;210948623;211695755;747132
Jacobs;H153;10;24;21584008;22865153;1281145
Jacobs;H153;10;46;31732075;34386151;2654076
Jacobs;H153;10;28;36883392;39457465;2574073
Jacobs;H153;10;33;47287047;48804938;1517891
Jacobs;H153;10;28;81023746;82225985;1202239
Jacobs;H153;24;42;96467;3507572;3411105
Jacobs;H153;24;48;16351007;20406106;4055099
Jacobs;H154;2;50;2451471;4697573;2246102
Jacobs;H154;2;23;14359717;15322091;962374
Jacobs;H154;2;15;16487040;17140743;653703
Jacobs;H154;2;48;26664802;30026978;3362176
Jacobs;H154;2;66;30638836;34303557;3664721
Jacobs;H154;2;82;40790032;45739882;4949850
Jacobs;H154;2;16;53991275;54669270;677995
Jacobs;H154;2;105;70548455;76783372;6234917
Jacobs;H154;2;19;121796989;123432784;1635795
Jacobs;H154;2;49;127699622;130206119;2506497
Jacobs;H154;2;20;131793590;132608113;814523
Jacobs;H154;2;22;132802249;133748186;945937
Jacobs;H154;2;37;141766599;143918492;2151893
Jacobs;H154;2;139;155064316;163070840;8006524
Jacobs;H154;2;64;186306661;190154694;3848033
Jacobs;H154;2;68;190267950;193596846;3328896
Jacobs;H154;2;48;199432096;202088645;2656549
Jacobs;H154;2;32;215098553;217890987;2792434
Jacobs;H154;2;15;220083076;220955491;872415
Jacobs;H154;10;81;16338178;20982790;4644612
Jacobs;H154;10;32;21682188;23289566;1607378
Jacobs;H154;10;62;25943893;29353089;3409196
Jacobs;H154;10;31;41802553;44430609;2628056
Jacobs;H154;10;18;48900679;49680970;780291
Jacobs;H154;10;21;84029946;85263429;1233483
Jacobs;H154;24;67;26493858;31359697;4865839
Jacobs;H155;2;50;2451471;4697573;2246102
Jacobs;H155;2;25;25563222;27209958;1646736
Jacobs;H155;2;16;53991275;54669270;677995
Jacobs;H155;2;97;58791324;63837976;5046652
Jacobs;H155;2;219;65962375;78426196;12463821
Jacobs;H155;2;19;121796989;123432784;1635795
Jacobs;H155;2;49;127699622;130206119;2506497
Jacobs;H155;2;37;162572509;164516447;1943938
Jacobs;H155;2;34;179521559;181909538;2387979
Jacobs;H155;2;45;208020229;210418618;2398389
Jacobs;H155;2;16;215498705;217457102;1958397
Jacobs;H155;2;15;218592494;219847222;1254728
Jacobs;H155;2;15;232591652;233589543;997891
Jacobs;H155;2;30;241748973;243449101;1700128
Jacobs;H155;10;27;16196817;17481523;1284706
Jacobs;H155;10;32;21682188;23289566;1607378
Jacobs;H155;10;62;25943893;29353089;3409196
Jacobs;H155;10;31;41802553;44430609;2628056
Jacobs;H155;10;18;48900679;49680970;780291
Jacobs;H155;24;34;26493858;29155367;2661509
Jacobs;H156;2;24;15568475;16829483;1261008
Jacobs;H156;2;39;24646366;26853708;2207342
Jacobs;H156;2;53;26932618;30698479;3765861
Jacobs;H156;2;26;30767128;31992177;1225049
Jacobs;H156;2;24;40790032;42499181;1709149
Jacobs;H156;2;23;54240741;55425163;1184422
Jacobs;H156;2;27;65962375;67597692;1635317
Jacobs;H156;2;62;67676280;71387561;3711281
Jacobs;H156;2;87;71490850;76627899;5137049
Jacobs;H156;2;16;79000514;80032995;1032481
Jacobs;H156;2;17;122060498;123432784;1372286
Jacobs;H156;2;28;162689295;164188754;1499459
Jacobs;H156;2;26;186306661;187836750;1530089
Jacobs;H156;2;16;187916592;188826201;909609
Jacobs;H156;2;23;192231314;193374050;1142736
Jacobs;H156;2;85;202088645;206382108;4293463
Jacobs;H156;2;42;207575434;209765359;2189925
Jacobs;H156;2;52;209830001;212749665;2919664
Jacobs;H156;2;43;213505877;217890987;4385110
Jacobs;H156;2;28;220343269;221633575;1290306
Jacobs;H156;2;109;223908949;229832513;5923564
Jacobs;H156;2;15;232591652;233589543;997891
Jacobs;H156;2;29;238940445;240477448;1537003
Jacobs;H156;10;16;6883264;8495362;1612098
Jacobs;H156;10;34;36637311;39457465;2820154
Jacobs;H156;10;70;46618259;49914859;3296600
Jacobs;H156;10;47;50995309;53147209;2151900
Jacobs;H156;10;54;59298205;62050961;2752756
Jacobs;H156;10;81;63706057;68575459;4869402
Jacobs;H156;10;88;71426400;76428043;5001643
Jacobs;H156;10;20;76572836;77507372;934536
Jacobs;H156;10;49;77939102;80465758;2526656
Jacobs;H156;10;35;80545891;82126706;1580815
Jacobs;H157;2;32;63635636;65017658;1382022
Jacobs;H157;2;28;65402955;67012655;1609700
Jacobs;H157;2;34;67676280;69441272;1764992
Jacobs;H157;2;23;93349246;94609125;1259879
Jacobs;H157;2;17;122060498;123432784;1372286
Jacobs;H157;2;15;129537914;130424187;886273
Jacobs;H157;2;40;147821995;149720801;1898806
Jacobs;H157;2;28;162689295;164188754;1499459
Jacobs;H157;2;33;204702992;206382108;1679116
Jacobs;H157;2;95;207575434;212749665;5174231
Jacobs;H157;2;37;213505877;217457102;3951225
Jacobs;H157;2;15;220083076;220955491;872415
Jacobs;H157;2;114;224283993;230323317;6039324
Jacobs;H157;10;15;1413129;2796718;1383589
Jacobs;H157;10;16;6883264;8495362;1612098
Jacobs;H157;10;34;36637311;39457465;2820154
Jacobs;H157;10;70;46618259;49914859;3296600
Jacobs;H157;10;50;50876668;53147209;2270541
Jacobs;H157;10;96;72510364;77142109;4631745
Jacobs;H157;10;16;77234571;78140084;905513
Jacobs;H157;10;84;82010502;86415081;4404579
Jacobs;H157;24;15;33798780;34666650;867870
Jacobs;H157;24;49;35106020;38916880;3810860
Jacobs;H158;2;50;2451471;4697573;2246102
Jacobs;H158;2;80;24839164;30026978;5187814
Jacobs;H158;2;103;51143878;56556228;5412350
Jacobs;H158;2;28;57861735;59231945;1370210
Jacobs;H158;2;194;89429616;101171470;11741854
Jacobs;H158;2;15;108736660;109420304;683644
Jacobs;H158;2;19;121796989;123432784;1635795
Jacobs;H158;2;49;127699622;130206119;2506497
Jacobs;H158;2;45;131793590;133748186;1954596
Jacobs;H158;2;35;140158515;141971484;1812969
Jacobs;H158;2;87;162689295;167432552;4743257
Jacobs;H158;2;604;170195998;205949338;35753340
Jacobs;H158;2;112;208020229;214228529;6208300
Jacobs;H158;2;16;215498705;217457102;1958397
Jacobs;H158;2;21;220083076;221216169;1133093
Jacobs;H158;2;27;226196223;227734587;1538364
Jacobs;H158;2;72;230657435;234947844;4290409
Jacobs;H158;2;32;236768061;238675170;1907109
Jacobs;H158;10;27;16196817;17481523;1284706
Jacobs;H158;10;32;21682188;23289566;1607378
Jacobs;H158;10;62;25943893;29353089;3409196
Jacobs;H158;10;18;36448017;37738237;1290220
Jacobs;H158;10;20;38727795;40071898;1344103
Jacobs;H158;10;38;48397749;50290499;1892750
Jacobs;H158;10;33;52284660;54216568;1931908
Jacobs;H158;10;40;56914955;59691651;2776696
Jacobs;H158;10;41;74924462;76973287;2048825
Jacobs;H158;24;19;2043961;3446498;1402537
Jacobs;H158;24;47;34553003;38357380;3804377
Jacobs;H158;24;15;40193947;41143981;950034
Jacobs;H159;2;494;26572518;56556228;29983710
Jacobs;H159;2;194;89429616;101171470;11741854
Jacobs;H159;2;15;108736660;109420304;683644
Jacobs;H159;2;19;121796989;123432784;1635795
Jacobs;H159;2;45;131793590;133748186;1954596
Jacobs;H159;2;35;140158515;141971484;1812969
Jacobs;H159;2;22;171171929;172311083;1139154
Jacobs;H159;2;72;181909538;186224877;4315339
Jacobs;H159;2;112;208020229;214228529;6208300
Jacobs;H159;2;23;233775867;235161178;1385311
Jacobs;H159;10;34;36637311;39457465;2820154
Jacobs;H159;10;18;53098812;54216568;1117756
Jacobs;H159;10;35;71426400;73826403;2400003
Jacobs;H159;10;21;84029946;85263429;1233483
Jacobs;H160;2;332;158066;18149828;17991762
Jacobs;H160;2;155;51529698;59231945;7702247
Jacobs;H160;2;19;72460390;73475221;1014831
Jacobs;H160;2;20;122060498;123528595;1468097
Jacobs;H160;2;117;135996954;142506224;6509270
Jacobs;H160;2;21;143557270;144672338;1115068
Jacobs;H160;2;65;151148561;155126465;3977904
Jacobs;H160;2;24;162513140;163845372;1332232
Jacobs;H160;2;17;165399749;166231789;832040
Jacobs;H160;2;114;172699752;180052852;7353100
Jacobs;H160;2;20;180402840;181909538;1506698
Jacobs;H160;2;32;187856073;189839836;1983763
Jacobs;H160;2;37;189930696;191673164;1742468
Jacobs;H160;2;19;193176635;194270296;1093661
Jacobs;H160;2;38;215844761;219847222;4002461
Jacobs;H160;2;97;233461442;238675170;5213728
Jacobs;H160;2;20;246478010;247455331;977321
Jacobs;H160;10;31;20540068;22285343;1745275
Jacobs;H160;10;111;23305210;29415140;6109930
Jacobs;H160;10;280;31509560;48804938;17295378
Jacobs;H160;10;28;53666062;55377753;1711691
Jacobs;H160;10;64;57261965;61065661;3803696
Jacobs;H160;10;35;68339290;70187303;1848013
Jacobs;H160;24;15;26493858;27739247;1245389
Jacobs;H161;2;140;158066;7973431;7815365
Jacobs;H161;2;16;31657214;32379564;722350
Jacobs;H161;2;35;40753889;43153034;2399145
Jacobs;H161;2;185;46045582;56556228;10510646
Jacobs;H161;2;19;72460390;73475221;1014831
Jacobs;H161;2;20;122060498;123528595;1468097
Jacobs;H161;2;116;135996954;142475803;6478849
Jacobs;H161;2;32;145745763;147821995;2076232
Jacobs;H161;2;142;149768329;158192547;8424218
Jacobs;H161;2;54;159389044;162321953;2932909
Jacobs;H161;2;38;215844761;219847222;4002461
Jacobs;H161;2;32;225936196;227734587;1798391
Jacobs;H161;10;226;20540068;32637918;12097850
Jacobs;H161;10;28;36883392;39457465;2574073
Jacobs;H161;10;18;40149974;40971187;821213
Jacobs;H161;10;33;47287047;48804938;1517891
Jacobs;H161;10;43;80545891;82687218;2141327
Jacobs;H161;24;38;11076801;13980455;2903654
Jacobs;H162;2;18;53670410;54386685;716275
Jacobs;H162;2;35;69626926;71793127;2166201
Jacobs;H162;2;72;72057797;76411172;4353375
Jacobs;H162;2;27;82507056;84069275;1562219
Jacobs;H162;2;21;121796989;123494681;1697692
Jacobs;H162;2;28;162689295;164188754;1499459
Jacobs;H162;2;41;172594808;175124550;2529742
Jacobs;H162;2;20;198155571;199020889;865318
Jacobs;H162;2;24;205336831;206643029;1306198
Jacobs;H162;2;42;210418618;212749665;2331047
Jacobs;H162;2;21;219357404;220852308;1494904
Jacobs;H162;2;104;231170715;236768061;5597346
Jacobs;H162;2;146;236977003;245737846;8760843
Jacobs;H162;10;16;18930071;19700851;770780
Jacobs;H162;10;44;30072709;32391424;2318715
Jacobs;H162;10;18;36448017;37738237;1290220
Jacobs;H162;10;31;41802553;44430609;2628056
Jacobs;H162;10;35;84678999;86415081;1736082
Jacobs;H162;24;18;8489860;9352754;862894
Jacobs;H162;24;25;16573702;18235931;1662229
Jacobs;H163;2;26;4008763;5179079;1170316
Jacobs;H163;2;50;16487040;19038121;2551081
Jacobs;H163;2;54;19128677;21928040;2799363
Jacobs;H163;2;28;22784701;24092677;1307976
Jacobs;H163;2;18;24839164;25709378;870214
Jacobs;H163;2;349;27355362;49355077;21999715
Jacobs;H163;2;32;49484087;51384849;1900762
Jacobs;H163;2;32;93451281;95025579;1574298
Jacobs;H163;2;198;106205323;119309807;13104484
Jacobs;H163;2;250;119388364;132608113;13219749
Jacobs;H163;2;37;132713568;134770618;2057050
Jacobs;H163;2;92;134809036;140044111;5235075
Jacobs;H163;2;18;147759341;148711192;951851
Jacobs;H163;2;20;148758742;149609364;850622
Jacobs;H163;2;290;181909538;198928938;17019400
Jacobs;H163;2;123;199020889;205454966;6434077
Jacobs;H163;2;34;215098553;217976690;2878137
Jacobs;H163;2;16;220780799;221413661;632862
Jacobs;H163;2;33;238940445;240721994;1781549
Jacobs;H163;10;30;17748924;19399049;1650125
Jacobs;H163;10;26;21584008;22955949;1371941
Jacobs;H163;10;83;34489447;40071898;5582451
Jacobs;H163;10;116;40149974;47487991;7338017
Jacobs;H163;10;39;47662790;49310196;1647406
Jacobs;H163;10;63;59298205;62634480;3336275
Jacobs;H163;10;41;62795305;66087045;3291740
Jacobs;H163;10;33;72757175;74308075;1550900
Jacobs;H163;10;54;78641554;81397746;2756192
Jacobs;H163;10;44;82994149;85263429;2269280
Jacobs;H164;2;39;3104266;4835268;1731002
Jacobs;H164;2;26;6349125;7973431;1624306
Jacobs;H164;2;43;26932618;30026978;3094360
Jacobs;H164;2;54;51143878;54086367;2942489
Jacobs;H164;2;66;54135888;57495366;3359478
Jacobs;H164;2;56;67428296;70721438;3293142
Jacobs;H164;2;73;70802060;75042274;4240214
Jacobs;H164;2;35;77200457;78792339;1591882
Jacobs;H164;2;86;79183271;83877361;4694090
Jacobs;H164;2;21;114411448;115743360;1331912
Jacobs;H164;2;15;116108127;117115355;1007228
Jacobs;H164;2;51;119388364;122001925;2613561
Jacobs;H164;2;101;122096448;127390949;5294501
Jacobs;H164;2;15;134667278;135391568;724290
Jacobs;H164;2;16;169494537;170563260;1068723
Jacobs;H164;2;22;171171929;172311083;1139154
Jacobs;H164;2;210;203829884;216807667;12977783
Jacobs;H164;10;65;1413129;5961075;4547946
Jacobs;H164;10;56;6042907;10108612;4065705
Jacobs;H164;10;56;17941764;21363789;3422025
Jacobs;H164;10;62;25943893;29353089;3409196
Jacobs;H164;10;27;32818994;34175819;1356825
Jacobs;H164;10;16;36637311;37738237;1100926
Jacobs;H164;10;31;41802553;44430609;2628056
Jacobs;H164;10;21;51591083;52388827;797744
Jacobs;H164;10;29;53098812;54955412;1856600
Jacobs;H164;10;22;56539784;57534184;994400
Jacobs;H164;10;23;63706057;65269159;1563102
Jacobs;H164;10;60;71426400;74998865;3572465
Jacobs;H164;10;18;79213622;80133131;919509
Jacobs;H164;24;17;15821681;17159602;1337921
Jacobs;H165;2;274;34376030;51606428;17230398
Jacobs;H165;2;1203;51777053;121239876;69462823
Jacobs;H165;2;15;122301320;123494681;1193361
Jacobs;H165;2;186;131397735;141439586;10041851
Jacobs;H165;2;83;142709866;147821995;5112129
Jacobs;H165;2;18;151148561;152160860;1012299
Jacobs;H165;2;160;155064316;164188754;9124438
Jacobs;H165;2;210;203829884;216807667;12977783
Jacobs;H165;2;32;225936196;227734587;1798391
Jacobs;H165;2;72;230657435;234947844;4290409
Jacobs;H165;2;32;236768061;238675170;1907109
Jacobs;H165;10;116;1413129;9736034;8322905
Jacobs;H165;10;66;10922307;14856146;3933839
Jacobs;H165;10;20;21309973;22376804;1066831
Jacobs;H165;10;17;31509560;32637918;1128358
Jacobs;H165;10;146;35566480;45845544;10279064
Jacobs;H165;10;21;55319894;56773821;1453927
Jacobs;H165;10;165;60005994;70187303;10181309
Jacobs;H165;10;128;71426400;78520137;7093737
