group;id;chrom;nSNP;from;to;lengthBps
Jacobs;H114;2;76;1606489;5215635;3609146
Jacobs;H114;2;44;5798140;8518359;2720219
Jacobs;H114;2;148;21979508;30849683;8870175
Jacobs;H114;2;45;35582012;38744795;3162783
Jacobs;H114;2;15;39198369;40023789;825420
Jacobs;H114;2;16;52327990;53043790;715800
Jacobs;H114;2;19;53986551;54687816;701265
Jacobs;H114;2;22;72875158;74090507;1215349
Jacobs;H114;2;104;79000514;84802665;5802151
Jacobs;H114;2;74;84938566;88789712;3851146
Jacobs;H114;2;18;91996530;93217367;1220837
Jacobs;H114;2;352;101171470;123644129;22472659
Jacobs;H114;2;15;129831656;130673052;841396
Jacobs;H114;2;38;133272817;135451498;2178681
Jacobs;H114;2;43;145994402;148711192;2716790
Jacobs;H114;2;15;170218116;171206036;987920
Jacobs;H114;2;16;198262211;198967974;705763
Jacobs;H114;2;18;215443702;217457102;2013400
Jacobs;H114;2;19;221216169;222027261;811092
Jacobs;H114;2;97;229248722;235032427;5783705
Jacobs;H114;2;15;236783616;237822440;1038824
Jacobs;H114;2;15;245309611;246317098;1007487
Jacobs;H114;24;17;96467;1377045;1280578
Jacobs;H114;24;32;11076801;13702846;2626045
Jacobs;H115;2;70;1645676;5039528;3393852
Jacobs;H115;2;17;20016014;20816743;800729
Jacobs;H115;2;16;52327990;53043790;715800
Jacobs;H115;2;19;53986551;54687816;701265
Jacobs;H115;2;218;56039866;67168555;11128689
Jacobs;H115;2;64;72875158;76732322;3857164
Jacobs;H115;2;74;84640849;88553200;3912351
Jacobs;H115;2;18;91996530;93217367;1220837
Jacobs;H115;2;131;96309972;104101891;7791919
Jacobs;H115;2;24;118134501;119654696;1520195
Jacobs;H115;2;23;122001925;123573014;1571089
Jacobs;H115;2;18;126622908;127390949;768041
Jacobs;H115;2;43;130145934;132323750;2177816
Jacobs;H115;2;51;139427894;141971484;2543590
Jacobs;H115;2;22;154579541;155797260;1217719
Jacobs;H115;2;81;167736523;172424726;4688203
Jacobs;H115;2;15;190574847;191307142;732295
Jacobs;H115;2;18;215443702;217457102;2013400
Jacobs;H115;2;18;217719922;219015064;1295142
Jacobs;H115;2;26;219847222;221354646;1507424
Jacobs;H115;2;87;243684242;248799264;5115022
Jacobs;H115;24;15;16077497;17253902;1176405
Jacobs;H115;24;72;26493858;31899729;5405871
Jacobs;H116;2;28;1675016;2991783;1316767
Jacobs;H116;2;20;4080987;4835268;754281
Jacobs;H116;2;15;20016014;20690263;674249
Jacobs;H116;2;15;43439988;44133953;693965
Jacobs;H116;2;34;51720147;53366034;1645887
Jacobs;H116;2;50;55908488;58123258;2214770
Jacobs;H116;2;28;65402955;67012655;1609700
Jacobs;H116;2;64;79000514;82192970;3192456
Jacobs;H116;2;88;84054194;88789712;4735518
Jacobs;H116;2;16;94894157;95731895;837738
Jacobs;H116;2;194;103331488;116534114;13202626
Jacobs;H116;2;27;121734938;123644129;1909191
Jacobs;H116;2;40;125273857;127088467;1814610
Jacobs;H116;2;27;127495017;129045322;1550305
Jacobs;H116;2;15;147910340;148711192;800852
Jacobs;H116;2;33;155026089;156798220;1772131
Jacobs;H116;2;20;157031272;158187310;1156038
Jacobs;H116;2;15;170218116;171206036;987920
Jacobs;H116;2;21;198116050;199020889;904839
Jacobs;H116;2;42;199225518;201797379;2571861
Jacobs;H116;2;227;202088645;215251657;13163012
Jacobs;H116;24;99;29375887;36160755;6784868
Jacobs;H26;2;16;5798140;6740866;942726
Jacobs;H26;2;18;7433654;8910387;1476733
Jacobs;H26;2;107;10376684;16096373;5719689
Jacobs;H26;2;19;53986551;54687816;701265
Jacobs;H26;2;112;68216266;74824143;6607877
Jacobs;H26;2;54;84938566;87916949;2978383
Jacobs;H26;2;49;91063757;93856462;2792705
Jacobs;H26;2;101;117369115;123446725;6077610
Jacobs;H26;2;15;124533614;125164918;631304
Jacobs;H26;2;18;133272817;134301618;1028801
Jacobs;H26;2;36;138618372;140442104;1823732
Jacobs;H26;2;67;140937497;144615833;3678336
Jacobs;H26;2;18;163695948;164516447;820499
Jacobs;H26;2;15;170218116;171206036;987920
Jacobs;H26;2;43;205223167;207694488;2471321
Jacobs;H26;2;40;212232636;215251657;3019021
Jacobs;H26;2;51;215994089;220852308;4858219
Jacobs;H26;2;22;226617529;227781732;1164203
Jacobs;H26;2;44;231069887;233623788;2553901
Jacobs;H26;24;73;16077497;22222030;6144533
Jacobs;H26;24;33;24314975;26681408;2366433
Jacobs;H32;2;109;158066;6092514;5934448
Jacobs;H32;2;66;8180894;11697656;3516762
Jacobs;H32;2;18;40839676;42000792;1161116
Jacobs;H32;2;17;110875234;112943535;2068301
Jacobs;H32;2;22;114411448;115784285;1372837
Jacobs;H32;2;18;115887593;117115355;1227762
Jacobs;H32;2;32;121515740;123644129;2128389
Jacobs;H32;2;60;134979525;138318697;3339172
Jacobs;H32;2;34;152160860;154331314;2170454
Jacobs;H32;24;31;17307132;19741398;2434266
Jacobs;H32;24;21;24776080;26068027;1291947
Jacobs;H32;24;15;31899729;32598869;699140
Navajo-Churro;H38;2;20;19145768;20157007;1011239
Navajo-Churro;H38;2;16;54086367;54744188;657821
Navajo-Churro;H38;2;20;72769457;73839087;1069630
Navajo-Churro;H38;2;16;113014357;114558942;1544585
Navajo-Churro;H38;2;22;131649580;132526868;877288
Navajo-Churro;H38;2;22;166839484;168068688;1229204
Navajo-Churro;H38;24;17;1807272;3031957;1224685
Navajo-Churro;H38;24;15;33225361;33879086;653725
Navajo-Churro;H44;2;16;52731947;53563082;831135
Navajo-Churro;H44;2;56;53797807;56521561;2723754
Navajo-Churro;H44;2;16;81407809;82013700;605891
Navajo-Churro;H44;2;16;113014357;114558942;1544585
Navajo-Churro;H44;2;23;148274554;149451928;1177374
Navajo-Churro;H44;2;664;160549720;199626176;39076456
Navajo-Churro;H44;2;22;234119904;235225978;1106074
Navajo-Churro;H44;2;15;235347013;235857471;510458
Navajo-Churro;H44;2;16;236398303;237488816;1090513
Navajo-Churro;H56;2;74;158066;4370486;4212420
Navajo-Churro;H56;2;15;50002207;51012330;1010123
Navajo-Churro;H56;2;172;86057456;95965733;9908277
Navajo-Churro;H56;2;16;113014357;114558942;1544585
Navajo-Churro;H56;2;19;178045098;179122335;1077237
Navajo-Churro;H56;2;16;200897370;201746518;849148
Navajo-Churro;H56;2;101;209994504;217457102;7462598
Jacobs;H50;2;20;4080987;4835268;754281
Jacobs;H50;2;80;6149666;10649928;4500262
Jacobs;H50;2;19;30109974;31144311;1034337
Jacobs;H50;2;15;46598180;48112634;1514454
Jacobs;H50;2;75;55160910;58830280;3669370
Jacobs;H50;2;21;65402955;66608553;1205598
Jacobs;H50;2;94;70664942;76142734;5477792
Jacobs;H50;2;94;92631842;98008059;5376217
Jacobs;H50;2;360;98817919;121330712;22512793
Jacobs;H50;2;26;121607287;123494681;1887394
Jacobs;H50;2;39;128510347;130673052;2162705
Jacobs;H50;2;21;131474019;132323750;849731
Jacobs;H50;2;25;136654969;138081646;1426677
Jacobs;H50;2;418;175936054;201514161;25578107
Jacobs;H50;2;17;203989901;204902549;912648
Jacobs;H50;2;75;230505362;235032427;4527065
Jacobs;H50;24;27;4000350;5874652;1874302
Jacobs;H50;24;52;5978910;8842899;2863989
Jacobs;H50;24;168;12065734;24859938;12794204
Jacobs;H50;24;17;32598869;33503397;904528
Jacobs;H27;2;406;158066;22144624;21986558
Jacobs;H27;2;17;40875507;42000792;1125285
Jacobs;H27;2;33;68216266;69890535;1674269
Jacobs;H27;2;15;73109758;73839087;729329
Jacobs;H27;2;130;84640849;92162531;7521682
Jacobs;H27;2;72;96566325;100951258;4384933
Jacobs;H27;2;17;103407822;104281644;873822
Jacobs;H27;2;23;122001925;123573014;1571089
Jacobs;H27;2;54;131474019;133942420;2468401
Jacobs;H27;2;18;163695948;164516447;820499
Jacobs;H27;2;15;170218116;171206036;987920
Jacobs;H27;2;45;186193337;188826201;2632864
Jacobs;H27;2;120;189799453;196669044;6869591
Jacobs;H27;2;15;206886750;207694488;807738
Jacobs;H27;2;163;209050239;220852308;11802069
Jacobs;H27;2;17;227127050;228074336;947286
Jacobs;H27;24;63;15367865;20406106;5038241
Jacobs;H27;24;17;36962278;37808477;846199
Navajo-Churro;H33;2;27;23366203;24839164;1472961
Navajo-Churro;H33;2;24;69660591;71218360;1557769
Navajo-Churro;H33;2;24;99302002;100753683;1451681
Navajo-Churro;H33;2;15;102413838;103237040;823202
Navajo-Churro;H33;2;60;106686708;109420304;2733596
Navajo-Churro;H33;2;280;116961397;132071815;15110418
Navajo-Churro;H33;2;29;133655932;135446006;1790074
Navajo-Churro;H33;2;19;141192562;142123229;930667
Navajo-Churro;H33;2;22;149451928;150532984;1081056
Navajo-Churro;H33;2;22;159122199;160549720;1427521
Navajo-Churro;H33;2;30;182124730;183679720;1554990
Navajo-Churro;H33;2;15;204726565;205454966;728401
Navajo-Churro;H33;2;16;211068237;211735126;666889
Navajo-Churro;H33;2;19;215594803;217736927;2142124
Navajo-Churro;H33;2;16;222552458;223184373;631915
Navajo-Churro;H33;2;53;223812677;226569909;2757232
Navajo-Churro;H33;2;19;242619137;243490742;871605
Navajo-Churro;H33;24;28;32623905;34113252;1489347
Navajo-Churro;H39;2;32;14359717;15897797;1538080
Navajo-Churro;H39;2;15;20046763;20767838;721075
Navajo-Churro;H39;2;333;75745623;94561848;18816225
Navajo-Churro;H39;2;16;102667770;103629915;962145
Navajo-Churro;H39;2;230;105595874;120634348;15038474
Navajo-Churro;H39;2;17;121484489;122429181;944692
Navajo-Churro;H39;2;18;160867028;161748310;881282
Navajo-Churro;H39;2;17;189799453;190643587;844134
Navajo-Churro;H39;2;19;223762044;224665736;903692
Navajo-Churro;H39;24;18;9865712;11526475;1660763
Navajo-Churro;H45;2;440;158066;23881589;23723523
Navajo-Churro;H45;2;19;65163534;66143622;980088
Navajo-Churro;H45;2;19;71387561;72460390;1072829
Navajo-Churro;H45;2;16;80343267;80942245;598978
Navajo-Churro;H45;2;66;92132718;95965733;3833015
Navajo-Churro;H45;2;21;151588637;152773944;1185307
Navajo-Churro;H45;2;16;153937847;154723424;785577
Navajo-Churro;H45;2;23;158749266;160185941;1436675
Navajo-Churro;H45;2;20;194376158;195861753;1485595
Navajo-Churro;H45;2;19;215680487;217925961;2245474
Navajo-Churro;H45;2;37;228897020;230926690;2029670
Navajo-Churro;H45;24;18;9460076;11326321;1866245
Navajo-Churro;H45;24;36;20734455;23689555;2955100
Navajo-Churro;H45;24;25;25523363;27613295;2089932
Navajo-Churro;H45;24;20;36938439;37965791;1027352
Jacobs;H51;2;86;158066;4835268;4677202
Jacobs;H51;2;98;7433654;13078663;5645009
Jacobs;H51;2;27;17033754;18555382;1521628
Jacobs;H51;2;28;22809937;24157644;1347707
Jacobs;H51;2;83;24756265;30109974;5353709
Jacobs;H51;2;35;51720147;53415584;1695437
Jacobs;H51;2;46;53986551;56154368;2167817
Jacobs;H51;2;126;59972946;66608553;6635607
Jacobs;H51;2;21;70664942;71844617;1179675
Jacobs;H51;2;47;107035638;109132360;2096722
Jacobs;H51;2;21;121796989;123494681;1697692
Jacobs;H51;2;51;132635669;135391568;2755899
Jacobs;H51;2;25;136654969;138081646;1426677
Jacobs;H51;2;89;142656135;148013217;5357082
Jacobs;H51;2;17;152048567;153128082;1079515
Jacobs;H51;2;22;159437585;160748450;1310865
Jacobs;H51;2;248;186193337;200658492;14465155
Jacobs;H51;2;18;205244432;206276753;1032321
Jacobs;H51;2;178;208232368;220903491;12671123
Jacobs;H51;2;32;221245334;222800960;1555626
Jacobs;H51;2;61;232957928;236120162;3162234
Jacobs;H51;24;18;96467;1435916;1339449
Jacobs;H51;24;134;12036238;22329952;10293714
Jacobs;H57;2;50;1906939;4351718;2444779
Jacobs;H57;2;518;39411236;68412890;29001654
Jacobs;H57;2;20;73508928;74700075;1191147
Jacobs;H57;2;221;90752876;103618164;12865288
Jacobs;H57;2;119;140622573;147650770;7028197
Jacobs;H57;2;128;199432096;206276753;6844657
Jacobs;H57;2;39;208935076;211068237;2133161
Jacobs;H57;2;28;215844761;219015064;3170303
Jacobs;H57;2;17;222919932;223762044;842112
Jacobs;H57;24;15;12558998;13761594;1202596
Jacobs;H57;24;96;17040364;24740555;7700191
Jacobs;H57;24;119;33056732;42027686;8970954
Navajo-Churro;H28;2;17;41567516;42668778;1101262
Navajo-Churro;H28;2;20;72769457;73839087;1069630
Navajo-Churro;H28;2;89;80125390;84938566;4813176
Navajo-Churro;H28;2;19;103640034;104876321;1236287
Navajo-Churro;H28;2;27;108235636;109633672;1398036
Navajo-Churro;H28;2;26;129421996;130880304;1458308
Navajo-Churro;H28;2;25;148479250;149553962;1074712
Navajo-Churro;H28;2;15;211151124;211767237;616113
Navajo-Churro;H28;2;35;238249575;240012290;1762715
Navajo-Churro;H28;24;25;21019195;23209530;2190335
Navajo-Churro;H34;2;240;14272947;26932618;12659671
Navajo-Churro;H34;2;24;40931803;42668778;1736975
Navajo-Churro;H34;2;359;75745623;95965733;20220110
Navajo-Churro;H34;2;15;114411448;115476148;1064700
Navajo-Churro;H34;2;595;160549720;195861753;35312033
Navajo-Churro;H34;2;23;202249334;203171974;922640
Navajo-Churro;H34;2;17;214020092;215594803;1574711
Navajo-Churro;H34;2;22;222800960;223856449;1055489
Navajo-Churro;H34;2;110;236398303;243050370;6652067
Navajo-Churro;H34;24;20;16041579;17514108;1472529
Navajo-Churro;H34;24;17;25638494;27091483;1452989
Jacobs;H40;2;24;158066;1906939;1748873
Jacobs;H40;2;15;3812405;4456589;644184
Jacobs;H40;2;16;21825858;22493681;667823
Jacobs;H40;2;15;39411236;40151930;740694
Jacobs;H40;2;16;52327990;53043790;715800
Jacobs;H40;2;19;53986551;54687816;701265
Jacobs;H40;2;92;70664942;76044554;5379612
Jacobs;H40;2;387;103407822;127173649;23765827
Jacobs;H40;2;142;133272817;141299872;8027055
Jacobs;H40;2;15;170218116;171206036;987920
Jacobs;H40;2;194;193151043;203989901;10838858
Jacobs;H40;2;17;205305554;206276753;971199
Jacobs;H40;2;47;212232636;215498705;3266069
Jacobs;H40;2;167;215844761;226784844;10940083
Jacobs;H40;2;16;232591652;233623788;1032136
Jacobs;H40;24;106;5485098;12550566;7065468
Jacobs;H40;24;69;17040364;22561935;5521571
Jacobs;H40;24;15;34225118;35585230;1360112
Jacobs;H40;24;17;38840214;39735778;895564
Jacobs;H40;24;19;40193947;42027686;1833739
Jacobs;H46;2;134;1645676;8910387;7264711
Jacobs;H46;2;28;22809937;24157644;1347707
Jacobs;H46;2;89;24756265;30589213;5832948
Jacobs;H46;2;40;46219946;49009193;2789247
Jacobs;H46;2;83;53304271;57495366;4191095
Jacobs;H46;2;20;73508928;74700075;1191147
Jacobs;H46;2;45;88992392;92132718;3140326
Jacobs;H46;2;34;93102704;94768669;1665965
Jacobs;H46;2;17;103407822;104281644;873822
Jacobs;H46;2;30;121607287;123644129;2036842
Jacobs;H46;2;69;130636386;134094336;3457950
Jacobs;H46;2;18;134667278;135474064;806786
Jacobs;H46;2;119;140622573;147650770;7028197
Jacobs;H46;2;15;170218116;171206036;987920
Jacobs;H46;2;46;215147086;219015064;3867978
Jacobs;H46;2;17;219847222;220955491;1108269
Jacobs;H46;2;16;222636869;223262207;625338
Jacobs;H46;2;15;236449805;237488816;1039011
Jacobs;H46;2;18;239564082;240647987;1083905
Jacobs;H46;24;61;5485098;8842899;3357801
Jacobs;H46;24;15;16077497;17253902;1176405
Jacobs;H46;24;49;17996334;22222030;4225696
Jacobs;H46;24;20;33313461;34176391;862930
Jacobs;H46;24;16;39300789;40336394;1035605
Navajo-Churro;H52;2;15;35564869;36228409;663540
Navajo-Churro;H52;2;24;50949347;52409379;1460032
Navajo-Churro;H52;2;21;80125390;80942245;816855
Navajo-Churro;H52;2;24;113394834;115525483;2130649
Navajo-Churro;H52;2;21;132341140;133229013;887873
Navajo-Churro;H52;2;16;145044081;145813854;769773
Navajo-Churro;H52;2;15;170218116;171206036;987920
Navajo-Churro;H52;2;15;212806608;213505877;699269
Navajo-Churro;H52;2;18;218418759;219933911;1515152
Navajo-Churro;H52;2;19;227921207;228848890;927683
Navajo-Churro;H52;24;25;21019195;23209530;2190335
Navajo-Churro;H58;2;17;4271242;5011935;740693
Navajo-Churro;H58;2;15;16042496;16774412;731916
Navajo-Churro;H58;2;15;72709484;73475221;765737
Navajo-Churro;H58;2;19;103640034;104876321;1236287
Navajo-Churro;H58;2;18;110083416;111172962;1089546
Navajo-Churro;H58;2;21;160907059;161921750;1014691
Navajo-Churro;H58;24;18;4866988;5951054;1084066
Navajo-Churro;H29;2;43;11449399;13794213;2344814
Navajo-Churro;H29;2;21;33770371;34802714;1032343
Navajo-Churro;H29;2;15;52100951;52790093;689142
Navajo-Churro;H29;2;16;62524786;63447389;922603
Navajo-Churro;H29;2;24;63675988;64741376;1065388
Navajo-Churro;H29;2;25;67387676;68670063;1282387
Navajo-Churro;H29;2;25;86669812;87906063;1236251
Navajo-Churro;H29;2;37;107709004;109633672;1924668
Navajo-Churro;H29;2;19;116465257;117413762;948505
Navajo-Churro;H29;2;66;187836750;191497969;3661219
Navajo-Churro;H29;2;15;215368972;215994089;625117
Navajo-Churro;H29;24;23;12335936;13980455;1644519
Navajo-Churro;H29;24;107;21629724;29910952;8281228
Jacobs;H35;2;20;10206141;10967299;761158
Jacobs;H35;2;19;39327845;40350901;1023056
Jacobs;H35;2;33;42499181;44430836;1931655
Jacobs;H35;2;158;48816011;57182355;8366344
Jacobs;H35;2;92;70664942;76044554;5379612
Jacobs;H35;2;42;84054194;86582074;2527880
Jacobs;H35;2;29;91143985;92891269;1747284
Jacobs;H35;2;20;109420304;110765081;1344777
Jacobs;H35;2;29;110875234;114279784;3404550
Jacobs;H35;2;23;116534114;117702396;1168282
Jacobs;H35;2;70;122001925;125884996;3883071
Jacobs;H35;2;15;128359488;129109277;749789
Jacobs;H35;2;16;130229606;131084439;854833
Jacobs;H35;2;74;136336816;140442104;4105288
Jacobs;H35;2;48;141299872;144088879;2789007
Jacobs;H35;2;38;145628424;147996276;2367852
Jacobs;H35;2;22;159437585;160748450;1310865
Jacobs;H35;2;192;207575434;220852308;13276874
Jacobs;H35;2;17;227127050;228074336;947286
Jacobs;H35;2;333;228485892;247635266;19149374
Jacobs;H35;24;49;96467;4276981;4180514
Jacobs;H35;24;30;7245176;8842899;1597723
Jacobs;H35;24;19;16077497;17514108;1436611
Jacobs;H35;24;29;29652597;31899729;2247132
Jacobs;H35;24;17;33879086;35216176;1337090
Navajo-Churro;H41;2;32;12636461;14359717;1723256
Navajo-Churro;H41;2;20;53837176;54681929;844753
Navajo-Churro;H41;2;323;66226023;84640849;18414826
Navajo-Churro;H41;2;403;92213984;117702396;25488412
Navajo-Churro;H41;2;18;121734938;123274303;1539365
Navajo-Churro;H41;2;225;139597601;152215629;12618028
Navajo-Churro;H41;2;347;167533866;189117884;21584018
Navajo-Churro;H41;2;19;209901734;210975950;1074216
Navajo-Churro;H41;2;16;218427149;219847222;1420073
Navajo-Churro;H41;2;23;236027912;237488816;1460904
Navajo-Churro;H41;24;107;96467;7796684;7700217
Navajo-Churro;H41;24;20;15893121;17460873;1567752
Navajo-Churro;H41;24;21;20406106;21910840;1504734
Navajo-Churro;H41;24;22;34113252;36076909;1963657
Jacobs;H47;2;79;6092514;10537097;4444583
Jacobs;H47;2;707;34484259;75042274;40558015
Jacobs;H47;2;24;108235636;109394432;1158796
Jacobs;H47;2;21;109766460;111002455;1235995
Jacobs;H47;2;160;117934792;126734704;8799912
Jacobs;H47;2;24;139427894;140518458;1090564
Jacobs;H47;2;15;147910340;148711192;800852
Jacobs;H47;2;22;151588637;152834616;1245979
Jacobs;H47;2;17;164152670;164923059;770389
Jacobs;H47;2;114;206427786;212806608;6378822
Jacobs;H47;2;24;213674776;215641893;1967117
Jacobs;H47;2;18;221245334;222027261;781927
Jacobs;H47;2;15;236347543;237315458;967915
Jacobs;H47;24;17;96467;1377045;1280578
Jacobs;H47;24;18;7483090;8379806;896716
Jacobs;H47;24;25;8741291;10709974;1968683
Jacobs;H47;24;90;13299441;19741398;6441957
Navajo-Churro;H53;2;20;3930781;4739830;809049
Navajo-Churro;H53;2;21;6587778;7672558;1084780
Navajo-Churro;H53;2;17;45031982;46146229;1114247
Navajo-Churro;H53;2;16;85589367;86333486;744119
Navajo-Churro;H53;2;16;94761838;95395889;634051
Navajo-Churro;H53;2;141;121299744;128972285;7672541
Navajo-Churro;H53;2;16;129295009;130145934;850925
Navajo-Churro;H53;2;24;131584922;132526868;941946
Navajo-Churro;H53;2;15;136887323;137576137;688814
Navajo-Churro;H53;2;20;144170136;145234800;1064664
Navajo-Churro;H53;2;19;148802744;149609364;806620
Navajo-Churro;H53;2;20;193596846;194853812;1256966
Navajo-Churro;H53;2;20;200044698;201345538;1300840
Navajo-Churro;H53;2;15;201656850;202253568;596718
Navajo-Churro;H53;2;19;212749665;213756591;1006926
Navajo-Churro;H53;2;87;231834142;236347543;4513401
Navajo-Churro;H53;2;20;238041313;239031909;990596
Navajo-Churro;H53;24;110;6468168;14275553;7807385
Navajo-Churro;H53;24;23;24989534;26759068;1769534
Jacobs;H59;2;88;158066;5039528;4881462
Jacobs;H59;2;121;16416165;22664271;6248106
Jacobs;H59;2;18;40839676;42000792;1161116
Jacobs;H59;2;18;101030254;101709271;679017
Jacobs;H59;2;17;110875234;112943535;2068301
Jacobs;H59;2;22;114411448;115784285;1372837
Jacobs;H59;2;17;115912934;117115355;1202421
Jacobs;H59;2;20;121515740;123048197;1532457
Jacobs;H59;2;121;131834108;138318697;6484589
Jacobs;H59;2;34;152160860;154331314;2170454
Jacobs;H59;2;16;163564272;164411911;847639
Jacobs;H59;2;15;167511192;168264380;753188
Jacobs;H59;2;20;175610830;177124764;1513934
Jacobs;H59;2;48;182286302;184885519;2599217
Jacobs;H59;2;15;190742274;191402600;660326
Jacobs;H59;2;15;207971469;208671645;700176
Jacobs;H59;24;20;18027756;19683887;1656131
Jacobs;H59;24;31;22222030;24591560;2369530
Jacobs;H59;24;15;31899729;32598869;699140
Navajo-Churro;H30;2;16;30785949;31564277;778328
Navajo-Churro;H30;2;16;36122230;37164388;1042158
Navajo-Churro;H30;2;17;41064340;42199949;1135609
Navajo-Churro;H30;2;18;52790093;53725483;935390
Navajo-Churro;H30;2;547;86266274;120426576;34160302
Navajo-Churro;H30;2;17;146616690;147910340;1293650
Navajo-Churro;H30;2;27;164152670;165447554;1294884
Navajo-Churro;H30;2;15;212806608;213505877;699269
Navajo-Churro;H30;2;18;218418759;219933911;1515152
Navajo-Churro;H30;2;19;227921207;228848890;927683
Navajo-Churro;H30;2;20;240477448;241612246;1134798
Navajo-Churro;H30;24;16;1527822;2920403;1392581
Navajo-Churro;H30;24;17;18027756;19347886;1320130
Navajo-Churro;H30;24;19;25961188;27680635;1719447
Navajo-Churro;H42;2;25;30173541;31519390;1345849
Navajo-Churro;H42;2;15;35302706;35929894;627188
Navajo-Churro;H42;2;15;48025916;48731082;705166
Navajo-Churro;H42;2;15;52025095;52714676;689581
Navajo-Churro;H42;2;68;67709618;71793127;4083509
Navajo-Churro;H42;2;19;83531972;84732669;1200697
Navajo-Churro;H42;2;17;100147522;100934715;787193
Navajo-Churro;H42;2;19;105769436;106830369;1060933
Navajo-Churro;H42;2;22;183539540;184813524;1273984
Navajo-Churro;H42;2;200;220556620;231069887;10513267
Jacobs;H48;2;16;5798140;6740866;942726
Jacobs;H48;2;83;10376684;14837808;4461124
Jacobs;H48;2;72;67488344;71739429;4251085
Jacobs;H48;2;15;73109758;73839087;729329
Jacobs;H48;2;145;92213984;100951258;8737274
Jacobs;H48;2;17;103407822;104281644;873822
Jacobs;H48;2;23;122001925;123573014;1571089
Jacobs;H48;2;39;139494558;141299872;1805314
Jacobs;H48;2;41;142270405;144615833;2345428
Jacobs;H48;2;15;167511192;168264380;753188
Jacobs;H48;2;16;172745053;173584797;839744
Jacobs;H48;2;39;176369323;178764936;2395613
Jacobs;H48;2;117;193151043;200044698;6893655
Jacobs;H48;2;22;211512445;212806608;1294163
Jacobs;H48;2;24;231069887;232414241;1344354
Jacobs;H48;2;15;239564082;240409281;845199
Jacobs;H48;24;39;10176168;13647199;3471031
Jacobs;H48;24;79;15367865;21629724;6261859
Jacobs;H48;24;25;27739247;29475441;1736194
Jacobs;H54;2;35;10376684;12330936;1954252
Jacobs;H54;2;19;25811615;26932618;1121003
Jacobs;H54;2;37;39198369;41567516;2369147
Jacobs;H54;2;27;74785937;76411172;1625235
Jacobs;H54;2;29;90752876;92132718;1379842
Jacobs;H54;2;47;107035638;109132360;2096722
Jacobs;H54;2;21;121796989;123494681;1697692
Jacobs;H54;2;46;126344239;128843993;2499754
Jacobs;H54;2;31;142709866;144572606;1862740
Jacobs;H54;2;30;153569061;155231390;1662329
Jacobs;H54;2;263;186193337;201496886;15303549
Jacobs;H54;2;61;214005350;219774612;5769262
Jacobs;H54;2;17;227127050;228074336;947286
Jacobs;H54;24;24;4674353;6101314;1426961
Jacobs;H54;24;135;13170165;23497703;10327538
Jacobs;H54;24;187;26142394;39711452;13569058
Navajo-Churro;H60;2;15;18801493;19281367;479874
Navajo-Churro;H60;2;16;52731947;53563082;831135
Navajo-Churro;H60;2;56;53797807;56521561;2723754
Navajo-Churro;H60;2;75;77328509;80904183;3575674
Navajo-Churro;H60;2;779;84580673;131210129;46629456
Navajo-Churro;H60;2;16;148802744;149539226;736482
Navajo-Churro;H60;2;16;152437856;153569061;1131205
Navajo-Churro;H60;2;29;171485026;173034908;1549882
Navajo-Churro;H60;2;15;189539157;190267950;728793
Navajo-Churro;H60;2;23;197415364;198563117;1147753
Navajo-Churro;H60;2;196;230505362;241649475;11144113
Navajo-Churro;H60;24;71;16147749;22222030;6074281
Navajo-Churro;H60;24;18;26068027;27739247;1671220
Navajo-Churro;H31;2;15;25125263;26100485;975222
Navajo-Churro;H31;2;59;48333814;51720147;3386333
Navajo-Churro;H31;2;22;54249685;55425163;1175478
Navajo-Churro;H31;2;22;73828642;75042274;1213632
Navajo-Churro;H31;2;16;113014357;114558942;1544585
Navajo-Churro;H31;2;15;168799360;169494537;695177
Navajo-Churro;H31;2;17;229965518;230926690;961172
Navajo-Churro;H31;24;22;10208845;12181694;1972849
Navajo-Churro;H31;24;17;31359697;32390507;1030810
Navajo-Churro;H37;2;21;1717596;2756505;1038909
Navajo-Churro;H37;2;19;6625835;7490500;864665
Navajo-Churro;H37;2;70;43109801;47450537;4340736
Navajo-Churro;H37;2;22;73828642;75042274;1213632
Navajo-Churro;H37;2;16;113014357;114558942;1544585
Navajo-Churro;H37;2;24;132208083;133229013;1020930
Navajo-Churro;H37;2;15;168799360;169494537;695177
Navajo-Churro;H37;2;17;229965518;230926690;961172
Navajo-Churro;H37;2;25;243907649;245206162;1298513
Navajo-Churro;H37;24;17;31359697;32390507;1030810
Navajo-Churro;H43;2;16;63770877;64459393;688516
Navajo-Churro;H43;2;17;67763382;68670063;906681
Navajo-Churro;H43;2;18;121734938;123274303;1539365
Navajo-Churro;H43;2;15;130673052;131584922;911870
Navajo-Churro;H43;2;23;148274554;149451928;1177374
Navajo-Churro;H43;2;1120;160549720;227044476;66494756
Navajo-Churro;H49;2;21;6587778;7672558;1084780
Navajo-Churro;H49;2;18;45015658;46146229;1130571
Navajo-Churro;H49;2;18;63770877;64542824;771947
Navajo-Churro;H49;2;17;66543498;67488344;944846
Navajo-Churro;H49;2;15;73828642;74700075;871433
Navajo-Churro;H49;2;16;108264568;108906253;641685
Navajo-Churro;H49;2;18;115476148;116265153;789005
Navajo-Churro;H49;2;18;121607287;123048197;1440910
Navajo-Churro;H49;2;28;124533614;125776688;1243074
Navajo-Churro;H49;2;16;132208083;132904756;696673
Navajo-Churro;H49;2;18;173910913;175124550;1213637
Navajo-Churro;H49;2;16;201430616;202080321;649705
Navajo-Churro;H49;2;101;209994504;217457102;7462598
Navajo-Churro;H49;2;16;242150818;243005095;854277
Navajo-Churro;H49;2;25;243907649;245206162;1298513
Navajo-Churro;H49;24;85;7107585;13231049;6123464
Jacobs;H55;2;15;3961544;4556476;594932
Jacobs;H55;2;21;5011935;6003251;991316
Jacobs;H55;2;15;26572518;27453783;881265
Jacobs;H55;2;137;43184130;51529698;8345568
Jacobs;H55;2;16;52327990;53043790;715800
Jacobs;H55;2;19;53986551;54687816;701265
Jacobs;H55;2;21;65402955;66608553;1205598
Jacobs;H55;2;36;68216266;70040931;1824665
Jacobs;H55;2;36;72759408;74824143;2064735
Jacobs;H55;2;98;77200457;81819011;4618554
Jacobs;H55;2;81;92063431;96713126;4649695
Jacobs;H55;2;30;121607287;123644129;2036842
Jacobs;H55;2;68;139131096;142593638;3462542
Jacobs;H55;2;37;156985451;159389044;2403593
Jacobs;H55;2;134;165399749;173034908;7635159
Jacobs;H55;2;25;237563114;238991301;1428187
Jacobs;H55;2;19;242462366;243302892;840526
Jacobs;H55;24;18;3439178;4766009;1326831
Jacobs;H55;24;68;12558998;17307132;4748134
Jacobs;H55;24;43;17996334;21581821;3585487
Jacobs;H55;24;19;33343694;34176391;832697
Navajo-Churro;H1;2;15;11400715;12330936;930221
Navajo-Churro;H1;2;19;15141339;16096373;955034
Navajo-Churro;H1;2;16;27784609;29338389;1553780
Navajo-Churro;H1;2;15;62482737;63387842;905105
Navajo-Churro;H1;2;36;71434200;73475221;2041021
Navajo-Churro;H1;2;75;77328509;80904183;3575674
Navajo-Churro;H1;2;70;84580673;88233994;3653321
Navajo-Churro;H1;2;19;144615833;145693768;1077935
Navajo-Churro;H1;2;18;148802744;149553962;751218
Navajo-Churro;H1;2;17;198339772;199110298;770526
Navajo-Churro;H1;2;44;202054228;203989901;1935673
Navajo-Churro;H1;24;17;15367865;16573702;1205837
Navajo-Churro;H1;24;18;26068027;27739247;1671220
Navajo-Churro;H9;2;85;9701540;14080986;4379446
Navajo-Churro;H9;2;17;25563222;26664802;1101580
Navajo-Churro;H9;2;1498;29912263;117934792;88022529
Navajo-Churro;H9;2;16;124657483;125343919;686436
Navajo-Churro;H9;2;19;131793590;132550706;757116
Navajo-Churro;H9;2;124;151200968;158665480;7464512
Navajo-Churro;H9;2;235;178647607;192989350;14341743
Navajo-Churro;H9;2;15;194755163;195890936;1135773
Navajo-Churro;H9;2;16;228660388;229397259;736871
Navajo-Churro;H9;2;111;236541718;243248420;6706702
Navajo-Churro;H9;24;40;29652597;32390507;2737910
Jacobs;H17;2;109;158066;6092514;5934448
Jacobs;H17;2;27;15477809;16975392;1497583
Jacobs;H17;2;16;28322438;29550469;1228031
Jacobs;H17;2;17;40875507;42000792;1125285
Jacobs;H17;2;92;70664942;76044554;5379612
Jacobs;H17;2;29;90752876;92132718;1379842
Jacobs;H17;2;47;107035638;109132360;2096722
Jacobs;H17;2;21;121796989;123494681;1697692
Jacobs;H17;2;468;126504764;152529090;26024326
Jacobs;H17;2;22;159437585;160748450;1310865
Jacobs;H17;2;136;164152670;171858694;7706024
Jacobs;H17;2;48;186366683;189186475;2819792
Jacobs;H17;2;15;192869029;193547722;678693
Jacobs;H17;2;16;198155571;198824819;669248
Jacobs;H17;2;37;204702992;206643029;1940037
Jacobs;H17;2;22;211512445;212806608;1294163
Jacobs;H17;2;31;230692645;232414241;1721596
Jacobs;H17;2;18;233988816;235032427;1043611
Jacobs;H17;2;58;240777646;244335478;3557832
Jacobs;H17;24;36;6265369;8314969;2049600
Jacobs;H17;24;31;17307132;19741398;2434266
Jacobs;H17;24;21;24776080;26068027;1291947
Jacobs;H17;24;25;27739247;29475441;1736194
Navajo-Churro;H2;2;17;22022061;22963619;941558
Navajo-Churro;H2;2;34;45015658;47450537;2434879
Navajo-Churro;H2;2;441;60095030;84640849;24545819
Navajo-Churro;H2;2;20;103466624;104524885;1058261
Navajo-Churro;H2;2;15;107866879;108527356;660477
Navajo-Churro;H2;2;19;110029030;111172962;1143932
Navajo-Churro;H2;2;20;113664053;115083516;1419463
Navajo-Churro;H2;2;99;220154626;225231192;5076566
Navajo-Churro;H2;2;80;230505362;235225978;4720616
Navajo-Churro;H2;2;38;235347013;237261566;1914553
Navajo-Churro;H2;2;16;242150818;243005095;854277
Navajo-Churro;H2;2;25;243907649;245206162;1298513
Navajo-Churro;H2;24;22;32984246;33961710;977464
Navajo-Churro;H2;24;28;36938439;38615161;1676722
Navajo-Churro;H10;2;32;14359717;15897797;1538080
Navajo-Churro;H10;2;15;20046763;20767838;721075
Navajo-Churro;H10;2;323;75745623;93932795;18187172
Navajo-Churro;H10;2;128;96439757;104016758;7577001
Navajo-Churro;H10;2;16;106470676;107171359;700683
Navajo-Churro;H10;2;31;108132547;109829764;1697217
Navajo-Churro;H10;2;17;121776284;123274303;1498019
Navajo-Churro;H10;2;17;146616690;147910340;1293650
Navajo-Churro;H10;2;18;169019218;170000512;981294
Navajo-Churro;H10;2;16;196296541;197177610;881069
Navajo-Churro;H10;2;18;199020889;199942549;921660
Navajo-Churro;H10;2;219;224864722;236768061;11903339
Navajo-Churro;H10;2;17;242676521;243449101;772580
Navajo-Churro;H10;24;25;27613295;29314003;1700708
Navajo-Churro;H19;2;16;52731947;53563082;831135
Navajo-Churro;H19;2;38;53797807;55548084;1750277
Navajo-Churro;H19;2;114;59112309;64886088;5773779
Navajo-Churro;H19;2;15;72436861;73188664;751803
Navajo-Churro;H19;2;16;113014357;114558942;1544585
Navajo-Churro;H19;2;24;132208083;133229013;1020930
Navajo-Churro;H19;2;17;147821995;148711192;889197
Navajo-Churro;H19;2;21;156467512;157574569;1107057
Navajo-Churro;H19;2;15;173352916;174139621;786705
Navajo-Churro;H19;2;35;189117884;191042331;1924447
Navajo-Churro;H19;2;58;191834956;195087922;3252966
Navajo-Churro;H19;2;18;202054228;202899103;844875
Navajo-Churro;H19;2;16;208564435;209401403;836968
Navajo-Churro;H19;2;16;209703200;210557713;854513
Navajo-Churro;H19;2;17;212232636;213148055;915419
Navajo-Churro;H19;2;37;228897020;230926690;2029670
Navajo-Churro;H19;2;23;236027912;237488816;1460904
Navajo-Churro;H19;24;64;16147749;21554660;5406911
Navajo-Churro;H3;2;23;16975392;18057959;1082567
Navajo-Churro;H3;2;15;19774453;20422624;648171
Navajo-Churro;H3;2;16;54086367;54744188;657821
Navajo-Churro;H3;2;22;73828642;75042274;1213632
Navajo-Churro;H3;2;15;85242819;86113413;870594
Navajo-Churro;H3;2;129;101171470;108470142;7298672
Navajo-Churro;H3;2;18;121734938;123274303;1539365
Navajo-Churro;H3;2;24;132208083;133229013;1020930
Navajo-Churro;H3;2;66;158192547;162219631;4027084
Navajo-Churro;H3;2;17;167736523;168665722;929199
Navajo-Churro;H3;2;19;204064678;205132747;1068069
Navajo-Churro;H3;24;22;10208845;12181694;1972849
Navajo-Churro;H3;24;15;16310285;17460873;1150588
Navajo-Churro;H3;24;17;25638494;27091483;1452989
Navajo-Churro;H11;2;66;9157918;12558695;3400777
Navajo-Churro;H11;2;16;12636461;13571895;935434
Navajo-Churro;H11;2;15;36140443;37164388;1023945
Navajo-Churro;H11;2;24;40931803;42668778;1736975
Navajo-Churro;H11;2;42;85508894;87744101;2235207
Navajo-Churro;H11;2;20;107866879;108775514;908635
Navajo-Churro;H11;2;16;184760567;185974821;1214254
Navajo-Churro;H11;2;35;189117884;191042331;1924447
Navajo-Churro;H11;24;26;9352754;11828268;2475514
Navajo-Churro;H11;24;30;21176747;23689555;2512808
Navajo-Churro;H11;24;22;33159082;34113252;954170
Navajo-Churro;H11;24;17;34345815;36036418;1690603
Navajo-Churro;H11;24;15;36962278;37716648;754370
Jacobs;H20;2;16;5798140;6740866;942726
Jacobs;H20;2;83;10376684;14837808;4461124
Jacobs;H20;2;32;38545616;40350901;1805285
Jacobs;H20;2;16;52327990;53043790;715800
Jacobs;H20;2;36;53304271;54936988;1632717
Jacobs;H20;2;79;57911484;61982604;4071120
Jacobs;H20;2;129;67488344;75042274;7553930
Jacobs;H20;2;106;75745623;80967126;5221503
Jacobs;H20;2;51;83531972;86582074;3050102
Jacobs;H20;2;22;91063757;92132718;1068961
Jacobs;H20;2;379;93102704;117158936;24056232
Jacobs;H20;2;23;122001925;123573014;1571089
Jacobs;H20;2;15;127997234;128625705;628471
Jacobs;H20;2;36;133272817;135391568;2118751
Jacobs;H20;2;25;136654969;138081646;1426677
Jacobs;H20;2;26;147210213;148953266;1743053
Jacobs;H20;2;16;158818859;159916624;1097765
Jacobs;H20;2;16;165486783;166276060;789277
Jacobs;H20;2;24;169929278;171362036;1432758
Jacobs;H20;2;116;179965972;187259707;7293735
Jacobs;H20;2;197;193151043;204071553;10920510
Jacobs;H20;2;51;215994089;220852308;4858219
Jacobs;H20;2;35;231069887;232977026;1907139
Jacobs;H20;2;28;247023852;248799264;1775412
Jacobs;H20;24;15;16077497;17253902;1176405
Jacobs;H20;24;71;17996334;24060526;6064192
Jacobs;H20;24;18;24314975;25523363;1208388
Jacobs;H20;24;18;29314003;30456600;1142597
Jacobs;H20;24;28;33397677;35216176;1818499
Navajo-Churro;H4;2;38;14359717;16264144;1904427
Navajo-Churro;H4;2;33;70548455;72500691;1952236
Navajo-Churro;H4;2;17;72891678;73839087;947409
Navajo-Churro;H4;2;19;88339215;89567061;1227846
Navajo-Churro;H4;2;15;110284541;111172962;888421
Navajo-Churro;H4;2;24;121590788;123362485;1771697
Navajo-Churro;H4;2;16;124825010;125442142;617132
Navajo-Churro;H4;2;15;127390949;128292892;901943
Navajo-Churro;H4;2;17;146616690;147910340;1293650
Navajo-Churro;H4;2;19;178741258;180183585;1442327
Navajo-Churro;H4;2;20;194755163;196283661;1528498
Navajo-Churro;H4;24;25;27613295;29314003;1700708
Navajo-Churro;H12;2;16;16042496;16805125;762629
Navajo-Churro;H12;2;80;25811615;31018254;5206639
Navajo-Churro;H12;2;20;53837176;54681929;844753
Navajo-Churro;H12;2;309;67168555;84705740;17537185
Navajo-Churro;H12;2;15;85242819;86113413;870594
Navajo-Churro;H12;2;513;95731895;127173649;31441754
Navajo-Churro;H12;2;15;173352916;174139621;786705
Navajo-Churro;H12;2;35;189117884;191042331;1924447
Navajo-Churro;H12;2;58;191834956;195087922;3252966
Navajo-Churro;H12;2;18;202054228;202899103;844875
Navajo-Churro;H12;2;17;218309332;219831281;1521949
Navajo-Churro;H12;2;16;226880698;227734587;853889
Navajo-Churro;H12;2;17;246615094;247548978;933884
Jacobs;H21;2;23;14914968;16096373;1181405
Jacobs;H21;2;17;18584559;19163821;579262
Jacobs;H21;2;15;20816743;21614658;797915
Jacobs;H21;2;19;39327845;40350901;1023056
Jacobs;H21;2;35;42199949;44430836;2230887
Jacobs;H21;2;720;48816011;87916949;39100938
Jacobs;H21;2;29;91143985;92891269;1747284
Jacobs;H21;2;20;109420304;110765081;1344777
Jacobs;H21;2;29;110875234;114279784;3404550
Jacobs;H21;2;23;116534114;117702396;1168282
Jacobs;H21;2;21;121796989;123494681;1697692
Jacobs;H21;2;40;142709866;145090781;2380915
Jacobs;H21;2;24;155026089;156230655;1204566
Jacobs;H21;2;20;158558328;159916624;1358296
Jacobs;H21;2;16;177951142;178741258;790116
Jacobs;H21;2;15;182286302;182923305;637003
Jacobs;H21;2;61;214005350;219774612;5769262
Jacobs;H21;2;20;220083076;221153389;1070313
Jacobs;H21;2;50;226617529;229189424;2571895
Jacobs;H21;2;29;230789586;232414241;1624655
Jacobs;H21;2;50;233988816;236285593;2296777
Jacobs;H21;24;24;7615311;8842899;1227588
Jacobs;H21;24;352;12065734;38184103;26118369
Jacobs;H13;2;190;39411236;51291515;11880279
Jacobs;H13;2;16;64771512;65574894;803382
Jacobs;H13;2;460;70664942;96963289;26298347
Jacobs;H13;2;447;100603953;127495017;26891064
Jacobs;H13;2;17;132841528;133563038;721510
Jacobs;H13;2;34;178388511;180818063;2429552
Jacobs;H13;2;15;206346660;207322502;975842
Jacobs;H13;2;50;211512445;215251657;3739212
Jacobs;H13;2;52;215844761;220852308;5007547
Jacobs;H13;2;15;225231192;226003694;772502
Jacobs;H13;2;31;229423565;231288643;1865078
Jacobs;H13;2;36;232260867;234602983;2342116
Jacobs;H13;2;19;235046820;235723972;677152
Jacobs;H13;2;16;238831242;239564082;732840
Jacobs;H13;24;95;16077497;24060526;7983029
Jacobs;H22;2;73;1482554;4835268;3352714
Jacobs;H22;2;48;11697656;14359717;2662061
Jacobs;H22;2;19;14837808;15741288;903480
Jacobs;H22;2;18;21334859;22316785;981926
Jacobs;H22;2;17;23963448;24861755;898307
Jacobs;H22;2;114;25709378;32893038;7183660
Jacobs;H22;2;36;68216266;70040931;1824665
Jacobs;H22;2;15;73109758;73839087;729329
Jacobs;H22;2;36;79183271;80967126;1783855
Jacobs;H22;2;70;92213984;96254860;4040876
Jacobs;H22;2;80;101183181;106302944;5119763
Jacobs;H22;2;271;116953479;131682707;14729228
Jacobs;H22;2;32;149470913;151200968;1730055
Jacobs;H22;2;15;157646578;158558328;911750
Jacobs;H22;2;17;172616581;173532404;915823
Jacobs;H22;2;27;176369323;178150411;1781088
Jacobs;H22;2;99;178388511;184673171;6284660
Jacobs;H22;2;69;196397256;200044698;3647442
Jacobs;H22;2;72;211512445;217457102;5944657
Jacobs;H22;2;54;222606287;225193189;2586902
Jacobs;H22;2;15;230006689;230823473;816784
Jacobs;H22;2;35;231069887;232977026;1907139
Jacobs;H22;24;77;12558998;17996334;5437336
Jacobs;H22;24;77;36036418;42027686;5991268
Navajo-Churro;H6;2;15;43932768;44728489;795721
Navajo-Churro;H6;2;15;60869601;61621077;751476
Navajo-Churro;H6;2;51;64504436;67387676;2883240
Navajo-Churro;H6;2;21;80125390;80942245;816855
Navajo-Churro;H6;2;18;105769436;106749240;979804
Navajo-Churro;H6;2;61;117795421;121299744;3504323
Navajo-Churro;H6;2;27;164152670;165447554;1294884
Navajo-Churro;H6;2;15;181165187;182097199;932012
Navajo-Churro;H6;2;21;241839716;243050370;1210654
Navajo-Churro;H6;24;15;24846522;25809786;963264
Navajo-Churro;H6;24;15;26493858;27739247;1245389
Navajo-Churro;H14;2;199;3563752;14359717;10795965
Navajo-Churro;H14;2;17;55946911;56751008;804097
Navajo-Churro;H14;2;15;79285145;80262318;977173
Navajo-Churro;H14;2;27;107227866;108309773;1081907
Navajo-Churro;H14;2;25;129421996;130831021;1409025
Navajo-Churro;H14;2;35;136336816;138159566;1822750
Navajo-Churro;H14;2;15;145693768;146381974;688206
Navajo-Churro;H14;2;22;165941483;167358125;1416642
Navajo-Churro;H14;2;19;175418941;176765339;1346398
Navajo-Churro;H14;2;18;190937309;191673164;735855
Navajo-Churro;H14;2;26;193596846;195428641;1831795
Navajo-Churro;H14;24;28;21176747;23509895;2333148
Jacobs;H7;2;15;13571895;14159758;587863
Jacobs;H7;2;180;16416165;25765503;9349338
Jacobs;H7;2;68;30463448;34096217;3632769
Jacobs;H7;2;36;39327845;41597285;2269440
Jacobs;H7;2;16;52327990;53043790;715800
Jacobs;H7;2;36;53304271;54936988;1632717
Jacobs;H7;2;79;57911484;61982604;4071120
Jacobs;H7;2;129;67488344;75042274;7553930
Jacobs;H7;2;139;75745623;82856320;7110697
Jacobs;H7;2;42;84054194;86582074;2527880
Jacobs;H7;2;49;91063757;93856462;2792705
Jacobs;H7;2;176;117369115;127043193;9674078
Jacobs;H7;2;124;133272817;140442104;7169287
Jacobs;H7;2;67;140937497;144615833;3678336
Jacobs;H7;2;18;163695948;164516447;820499
Jacobs;H7;2;15;170218116;171206036;987920
Jacobs;H7;2;89;199432096;203989901;4557805
Jacobs;H7;2;41;205305554;207694488;2388934
Jacobs;H7;2;27;215994089;219015064;3020975
Jacobs;H7;24;31;11076801;13647199;2570398
Jacobs;H7;24;67;16077497;21581821;5504324
Jacobs;H7;24;15;34225118;35585230;1360112
Jacobs;H7;24;17;38840214;39735778;895564
Jacobs;H7;24;19;40193947;42027686;1833739
Navajo-Churro;H15;2;189;14272947;24005033;9732086
Navajo-Churro;H15;2;21;53797807;54681929;884122
Navajo-Churro;H15;2;172;56413369;64886088;8472719
Navajo-Churro;H15;2;15;72436861;73188664;751803
Navajo-Churro;H15;2;864;92132718;142902297;50769579
Navajo-Churro;H15;2;21;144500078;145628424;1128346
Navajo-Churro;H15;2;15;173352916;174139621;786705
Navajo-Churro;H15;2;20;182607165;183721180;1114015
Navajo-Churro;H15;2;93;243302892;248799264;5496372
Navajo-Churro;H15;24;19;25614223;27159621;1545398
Navajo-Churro;H15;24;16;31774063;32552648;778585
Navajo-Churro;H24;2;22;46045582;47853771;1808189
Navajo-Churro;H24;2;19;54135888;54936988;801100
Navajo-Churro;H24;2;20;72769457;73839087;1069630
Navajo-Churro;H24;2;21;84705740;85982773;1277033
Navajo-Churro;H24;2;21;86798921;87816239;1017318
Navajo-Churro;H24;2;17;142123229;143177828;1054599
Navajo-Churro;H24;2;21;144500078;145628424;1128346
Navajo-Churro;H24;2;19;175418941;176765339;1346398
Navajo-Churro;H24;2;15;189470005;190239376;769371
Navajo-Churro;H24;2;20;242462366;243365308;902942
Navajo-Churro;H24;24;21;20406106;21910840;1504734
Navajo-Churro;H24;24;22;34113252;36076909;1963657
Navajo-Churro;H8;2;15;1426911;2157185;730274
Navajo-Churro;H8;2;17;41567516;42668778;1101262
Navajo-Churro;H8;2;19;54135888;54936988;801100
Navajo-Churro;H8;2;20;71434200;72607674;1173474
Navajo-Churro;H8;2;17;73046724;73926990;880266
Navajo-Churro;H8;2;16;80343267;80942245;598978
Navajo-Churro;H8;2;17;88681374;90205014;1523640
Navajo-Churro;H8;2;19;103640034;104876321;1236287
Navajo-Churro;H8;2;27;108235636;109633672;1398036
Navajo-Churro;H8;2;26;129421996;130880304;1458308
Navajo-Churro;H8;2;25;148479250;149553962;1074712
Navajo-Churro;H8;2;18;212749665;213674776;925111
Navajo-Churro;H8;2;18;218418759;219933911;1515152
Navajo-Churro;H8;2;19;227921207;228848890;927683
Navajo-Churro;H8;24;59;5384735;8579698;3194963
Jacobs;H16;2;20;10206141;10967299;761158
Jacobs;H16;2;23;14914968;16096373;1181405
Jacobs;H16;2;17;18584559;19163821;579262
Jacobs;H16;2;15;20816743;21614658;797915
Jacobs;H16;2;36;39327845;41597285;2269440
Jacobs;H16;2;16;52327990;53043790;715800
Jacobs;H16;2;36;53304271;54936988;1632717
Jacobs;H16;2;79;57911484;61982604;4071120
Jacobs;H16;2;129;67488344;75042274;7553930
Jacobs;H16;2;139;75745623;82856320;7110697
Jacobs;H16;2;42;84054194;86582074;2527880
Jacobs;H16;2;49;91063757;93856462;2792705
Jacobs;H16;2;101;117369115;123446725;6077610
Jacobs;H16;2;15;124533614;125164918;631304
Jacobs;H16;2;18;133272817;134301618;1028801
Jacobs;H16;2;20;140158515;141180010;1021495
Jacobs;H16;2;16;154256628;155107453;850825
Jacobs;H16;2;18;163695948;164516447;820499
Jacobs;H16;2;15;170218116;171206036;987920
Jacobs;H16;2;15;195245620;196397256;1151636
Jacobs;H16;2;50;211512445;215251657;3739212
Jacobs;H16;2;52;215844761;220852308;5007547
Jacobs;H16;2;22;226617529;227781732;1164203
Jacobs;H16;2;24;231069887;232414241;1344354
Jacobs;H16;2;31;238831242;240477448;1646206
Jacobs;H16;2;15;247955981;248650282;694301
Jacobs;H16;24;17;5621749;6468168;846419
Jacobs;H16;24;20;9010958;10471141;1460183
Jacobs;H16;24;71;16147749;22222030;6074281
Jacobs;H16;24;15;34225118;35585230;1360112
Navajo-Churro;H25;2;29;9589549;10835399;1245850
Navajo-Churro;H25;2;16;11400715;12418291;1017576
Navajo-Churro;H25;2;18;15035660;15897797;862137
Navajo-Churro;H25;2;35;20921329;22784701;1863372
Navajo-Churro;H25;2;45;34089866;36286992;2197126
Navajo-Churro;H25;2;39;52050037;54047306;1997269
Navajo-Churro;H25;2;21;80125390;80942245;816855
Navajo-Churro;H25;2;19;103640034;104876321;1236287
Navajo-Churro;H25;2;18;110083416;111172962;1089546
Navajo-Churro;H25;2;22;168799360;170000512;1201152
Navajo-Churro;H25;2;22;178741258;180371082;1629824
Navajo-Churro;H25;2;18;198596572;199312723;716151
Navajo-Churro;H25;2;22;209637524;210708881;1071357
Navajo-Churro;H25;2;16;228531586;229349932;818346
Navajo-Churro;H25;2;23;230439460;231769134;1329674
Navajo-Churro;H25;2;15;239390747;240281174;890427
Navajo-Churro;H25;2;20;241950529;243050370;1099841
Jacobs;H64;2;45;354035;2991783;2637748
Jacobs;H64;2;22;7727437;9369266;1641829
Jacobs;H64;2;30;11697656;13473852;1776196
Jacobs;H64;2;23;25811615;27218367;1406752
Jacobs;H64;2;32;38506443;40269973;1763530
Jacobs;H64;2;15;52409379;53043790;634411
Jacobs;H64;2;19;53986551;54687816;701265
Jacobs;H64;2;92;70664942;76044554;5379612
Jacobs;H64;2;247;76627899;90557732;13929833
Jacobs;H64;2;16;94894157;95731895;837738
Jacobs;H64;2;24;96254860;97741243;1486383
Jacobs;H64;2;86;100147522;105189556;5042034
Jacobs;H64;2;17;125261082;125922359;661277
Jacobs;H64;2;35;130636386;132323750;1687364
Jacobs;H64;2;23;140044111;141180010;1135899
Jacobs;H64;2;42;142250151;144615833;2365682
Jacobs;H64;2;24;157697393;159389044;1691651
Jacobs;H64;2;117;165399749;172151603;6751854
Jacobs;H64;2;131;198217868;204997139;6779271
Jacobs;H64;2;55;211512445;215443702;3931257
Jacobs;H64;2;51;215844761;220818676;4973915
Jacobs;H64;2;38;241649475;244066362;2416887
Jacobs;H64;24;77;12558998;17996334;5437336
Jacobs;H64;24;28;33397677;35216176;1818499
Jacobs;H62;2;40;4166902;6003251;1836349
Jacobs;H62;2;27;8180894;9735180;1554286
Jacobs;H62;2;135;15568475;22664271;7095796
Jacobs;H62;2;85;66730561;71739429;5008868
Jacobs;H62;2;15;73109758;73839087;729329
Jacobs;H62;2;51;86104148;88553200;2449052
Jacobs;H62;2;26;121231306;122918820;1687514
Jacobs;H62;2;55;131474019;134094336;2620317
Jacobs;H62;2;17;134667278;135451498;784220
Jacobs;H62;2;140;179122335;188204145;9081810
Jacobs;H62;2;15;208020229;208676009;655780
Jacobs;H62;2;17;215812352;218058406;2246054
Jacobs;H62;24;73;12181694;17307132;5125438
Jacobs;H62;24;18;24925070;26068027;1142957
Jacobs;H62;24;25;27739247;29475441;1736194
Navajo-Churro;H63;2;24;45150277;46557607;1407330
Navajo-Churro;H63;2;17;55974621;56804497;829876
Navajo-Churro;H63;2;19;103640034;104876321;1236287
Navajo-Churro;H63;2;18;110083416;111172962;1089546
Navajo-Churro;H63;2;20;189139931;190302285;1162354
Navajo-Churro;H63;24;22;12129478;13767641;1638163
Navajo-Churro;H63;24;19;25961188;27680635;1719447
Jacobs;H118;2;16;10266961;10887825;620864
Jacobs;H118;2;25;20016014;21129571;1113557
Jacobs;H118;2;17;32268777;33270908;1002131
Jacobs;H118;2;18;35582012;36544130;962118
Jacobs;H118;2;102;51529698;56751008;5221310
Jacobs;H118;2;19;73828642;74891548;1062906
Jacobs;H118;2;45;79017511;81273844;2256333
Jacobs;H118;2;58;83115753;86582074;3466321
Jacobs;H118;2;16;101134453;101709271;574818
Jacobs;H118;2;233;102804384;118180362;15375978
Jacobs;H118;2;19;119165943;120073154;907211
Jacobs;H118;2;15;122301320;123494681;1193361
Jacobs;H118;2;39;133272817;135474064;2201247
Jacobs;H118;2;50;140044111;142593638;2549527
Jacobs;H118;2;24;178010644;179673400;1662756
Jacobs;H118;2;60;187856073;191307142;3451069
Jacobs;H118;2;31;198875303;200749064;1873761
Jacobs;H118;2;31;203877619;205572258;1694639
Jacobs;H118;2;22;211512445;212806608;1294163
Jacobs;H118;2;88;215147086;221624187;6477101
Jacobs;H118;2;87;221940916;226477839;4536923
Jacobs;H118;2;78;233461442;237613535;4152093
Jacobs;H118;2;15;244129054;244947713;818659
Jacobs;H118;24;16;15865169;17159602;1294433
Jacobs;H118;24;16;26493858;27928201;1434343
Jacobs;H119;2;109;158066;6092514;5934448
Jacobs;H119;2;31;13307050;14837808;1530758
Jacobs;H119;2;78;15322091;19404154;4082063
Jacobs;H119;2;86;29409606;34303557;4893951
Jacobs;H119;2;86;40790032;46146229;5356197
Jacobs;H119;2;15;49484087;50080258;596171
Jacobs;H119;2;97;58791324;63837976;5046652
Jacobs;H119;2;176;65876876;76464705;10587829
Jacobs;H119;2;43;80262318;82192970;1930652
Jacobs;H119;2;17;103407822;104281644;873822
Jacobs;H119;2;23;122001925;123573014;1571089
Jacobs;H119;2;17;134194138;135084325;890187
Jacobs;H119;2;31;162689295;164308657;1619362
Jacobs;H119;2;15;198176953;198824819;647866
Jacobs;H119;2;16;215443702;216807667;1363965
Jacobs;H119;2;16;231543005;232414241;871236
Jacobs;H119;2;16;232591652;233623788;1032136
Jacobs;H119;2;31;241649475;243449101;1799626
Jacobs;H119;2;26;246116878;247245173;1128295
Jacobs;H119;24;23;8170749;9268996;1098247
Jacobs;H119;24;21;15324479;16892562;1568083
Jacobs;H119;24;15;24776080;25710129;934049
Jacobs;H120;2;86;29409606;34303557;4893951
Jacobs;H120;2;86;40790032;46146229;5356197
Jacobs;H120;2;15;49484087;50080258;596171
Jacobs;H120;2;97;58791324;63837976;5046652
Jacobs;H120;2;256;65876876;80421373;14544497
Jacobs;H120;2;43;81758958;84580673;2821715
Jacobs;H120;2;17;94981400;96022899;1041499
Jacobs;H120;2;18;108309773;109132360;822587
Jacobs;H120;2;17;110606314;112190964;1584650
Jacobs;H120;2;25;114883685;116350674;1466989
Jacobs;H120;2;16;116635922;117464089;828167
Jacobs;H120;2;23;122001925;123573014;1571089
Jacobs;H120;2;22;128625705;129602869;977164
Jacobs;H120;2;39;131397735;133040292;1642557
Jacobs;H120;2;40;140827873;142963793;2135920
Jacobs;H120;2;31;162689295;164308657;1619362
Jacobs;H120;2;16;198155571;198824819;669248
Jacobs;H120;2;16;215443702;216807667;1363965
Jacobs;H120;2;16;231543005;232414241;871236
Jacobs;H120;2;16;232591652;233623788;1032136
Jacobs;H120;2;22;241649475;243005095;1355620
Jacobs;H120;2;21;246478010;247498052;1020042
Jacobs;H120;2;16;247955981;248799264;843283
Jacobs;H121;2;22;4080987;5039528;958541
Jacobs;H121;2;22;6625835;7925142;1299307
Jacobs;H121;2;51;19038121;21756019;2717898
Jacobs;H121;2;42;29717625;31978915;2261290
Jacobs;H121;2;27;49602010;51384849;1782839
Jacobs;H121;2;29;66730561;68326509;1595948
Jacobs;H121;2;34;69626926;71739429;2112503
Jacobs;H121;2;15;73109758;73839087;729329
Jacobs;H121;2;36;79183271;80967126;1783855
Jacobs;H121;2;69;82290592;86582074;4291482
Jacobs;H121;2;41;88080464;90977972;2897508
Jacobs;H121;2;67;91063757;94768669;3704912
Jacobs;H121;2;47;107035638;109132360;2096722
Jacobs;H121;2;21;121796989;123494681;1697692
Jacobs;H121;2;17;129537914;130606432;1068518
Jacobs;H121;2;24;131596312;132550706;954394
Jacobs;H121;2;23;136632758;137832529;1199771
Jacobs;H121;2;24;148986290;150059057;1072767
Jacobs;H121;2;15;156555652;157252102;696450
Jacobs;H121;2;15;167511192;168264380;753188
Jacobs;H121;2;19;189470005;190441232;971227
Jacobs;H121;2;23;198495174;199546123;1050949
Jacobs;H121;2;32;200294436;202080321;1785885
Jacobs;H121;2;16;215443702;216807667;1363965
Jacobs;H121;2;123;223876023;230439460;6563437
Jacobs;H121;2;16;235184763;235723972;539209
Jacobs;H121;2;15;239564082;240409281;845199
Jacobs;H121;24;23;8170749;9268996;1098247
Jacobs;H121;24;15;15324479;16147749;823270
Jacobs;H121;24;17;19946691;21392558;1445867
Jacobs;H121;24;72;23828331;29197813;5369482
Jacobs;H122;2;80;945715;4835268;3889553
Jacobs;H122;2;24;14359717;15388156;1028439
Jacobs;H122;2;51;26520393;30051860;3531467
Jacobs;H122;2;66;54135888;57495366;3359478
Jacobs;H122;2;105;70548455;76783372;6234917
Jacobs;H122;2;42;84054194;86582074;2527880
Jacobs;H122;2;18;101030254;101709271;679017
Jacobs;H122;2;15;110083416;110941391;857975
Jacobs;H122;2;21;121796989;123494681;1697692
Jacobs;H122;2;25;127306102;128843993;1537891
Jacobs;H122;2;23;130368989;131682707;1313718
Jacobs;H122;2;26;132749103;134094336;1345233
Jacobs;H122;2;16;134667278;135446006;778728
Jacobs;H122;2;16;148986290;149553962;567672
Jacobs;H122;2;16;190574847;191319781;744934
Jacobs;H122;2;18;215443702;217457102;2013400
Jacobs;H122;2;44;217719922;220955491;3235569
Jacobs;H122;2;47;221633575;224027318;2393743
Jacobs;H122;2;16;231543005;232414241;871236
Jacobs;H122;2;16;232591652;233623788;1032136
Jacobs;H122;2;16;239510065;240409281;899216
Jacobs;H122;24;51;5593329;8379806;2786477
Jacobs;H122;24;15;15324479;16147749;823270
Jacobs;H122;24;17;19946691;21392558;1445867
Jacobs;H122;24;71;24040495;29197813;5157318
Jacobs;H123;2;16;37164388;38506443;1342055
Jacobs;H123;2;16;52327990;53043790;715800
Jacobs;H123;2;19;53986551;54687816;701265
Jacobs;H123;2;17;56446750;57307599;860849
Jacobs;H123;2;20;108235636;109132360;896724
Jacobs;H123;2;24;113897647;115665643;1767996
Jacobs;H123;2;23;122001925;123573014;1571089
Jacobs;H123;2;15;135636519;136565040;928521
Jacobs;H123;2;71;150948753;155337073;4388320
Jacobs;H123;2;23;168719169;170000512;1281343
Jacobs;H123;2;16;190574847;191319781;744934
Jacobs;H123;2;113;208020229;215098553;7078324
Jacobs;H123;2;18;215443702;217457102;2013400
Jacobs;H123;2;15;236541718;237613535;1071817
Jacobs;H123;2;15;246121938;246701174;579236
Jacobs;H123;24;44;11076801;14492312;3415511
Jacobs;H124;2;17;3961544;4670884;709340
Jacobs;H124;2;60;16416165;19404154;2987989
Jacobs;H124;2;27;25939009;27546603;1607594
Jacobs;H124;2;183;49602010;59306755;9704745
Jacobs;H124;2;29;66730561;68326509;1595948
Jacobs;H124;2;18;70802060;71844617;1042557
Jacobs;H124;2;15;73109758;73839087;729329
Jacobs;H124;2;36;80857803;82706925;1849122
Jacobs;H124;2;24;92213984;93601809;1387825
Jacobs;H124;2;27;94894157;96566325;1672168
Jacobs;H124;2;25;101985195;103407822;1422627
Jacobs;H124;2;191;116350674;126926047;10575373
Jacobs;H124;2;60;129421996;132550706;3128710
Jacobs;H124;2;34;142709866;144672338;1962472
Jacobs;H124;2;91;157252102;162572509;5320407
Jacobs;H124;2;15;176695897;177580706;884809
Jacobs;H124;2;17;199076879;199942549;865670
Jacobs;H124;2;18;205244432;206276753;1032321
Jacobs;H124;2;132;208232368;217457102;9224734
Jacobs;H124;2;20;218058406;219694019;1635613
Jacobs;H124;2;44;238041313;240409281;2367968
Jacobs;H124;24;17;23497703;24690825;1193122
Jacobs;H125;2;28;44660277;46163449;1503172
Jacobs;H125;2;17;73046724;73926990;880266
Jacobs;H125;2;55;84054194;87222916;3168722
Jacobs;H125;2;18;101030254;101709271;679017
Jacobs;H125;2;47;107035638;109132360;2096722
Jacobs;H125;2;21;121796989;123494681;1697692
Jacobs;H125;2;26;149768329;151345671;1577342
Jacobs;H125;2;37;162689295;164594319;1905024
Jacobs;H125;2;17;171889296;172616581;727285
Jacobs;H125;2;15;175346551;176135485;788934
Jacobs;H125;2;28;189117884;190697862;1579978
Jacobs;H125;2;36;200125811;202249334;2123523
Jacobs;H125;2;23;215994089;218592494;2598405
Jacobs;H125;2;41;219357404;221711968;2354564
Jacobs;H125;2;123;223876023;230439460;6563437
Jacobs;H125;24;74;26493858;31947993;5454135
Jacobs;H126;2;92;46491700;52266474;5774774
Jacobs;H126;2;23;53528684;54596587;1067903
Jacobs;H126;2;19;70664942;71739429;1074487
Jacobs;H126;2;15;73109758;73839087;729329
Jacobs;H126;2;74;80701449;84891847;4190398
Jacobs;H126;2;20;86266274;87222916;956642
Jacobs;H126;2;16;101134453;101709271;574818
Jacobs;H126;2;15;110083416;110941391;857975
Jacobs;H126;2;21;121796989;123494681;1697692
Jacobs;H126;2;35;133272817;135337045;2064228
Jacobs;H126;2;108;170058634;176450447;6391813
Jacobs;H126;2;86;186306661;191307142;5000481
Jacobs;H126;2;16;198155571;198824819;669248
Jacobs;H126;2;22;211512445;212806608;1294163
Jacobs;H126;2;24;213674776;215641893;1967117
Jacobs;H126;2;60;217719922;221624187;3904265
Jacobs;H126;2;42;221940916;224027318;2086402
Jacobs;H126;2;28;230439460;232022650;1583190
Jacobs;H126;24;17;15762894;17133716;1370822
Jacobs;H126;24;42;28877449;31947993;3070544
Jacobs;H126;24;29;39603557;42027686;2424129
Jacobs;H127;2;31;4431496;5940814;1509318
Jacobs;H127;2;17;21789864;22493681;703817
Jacobs;H127;2;42;31712060;34096217;2384157
Jacobs;H127;2;27;45320994;47352919;2031925
Jacobs;H127;2;51;54135888;56751008;2615120
Jacobs;H127;2;19;72875158;73926990;1051832
Jacobs;H127;2;36;79183271;80967126;1783855
Jacobs;H127;2;101;82290592;88172646;5882054
Jacobs;H127;2;47;107035638;109132360;2096722
Jacobs;H127;2;21;121796989;123494681;1697692
Jacobs;H127;2;99;144342270;149768329;5426059
Jacobs;H127;2;108;170058634;176450447;6391813
Jacobs;H127;2;15;198176953;198824819;647866
Jacobs;H127;2;22;211512445;212806608;1294163
Jacobs;H127;2;24;213674776;215641893;1967117
Jacobs;H127;2;60;217719922;221624187;3904265
Jacobs;H127;2;42;221940916;224027318;2086402
Jacobs;H127;2;28;230439460;232022650;1583190
Jacobs;H127;2;29;238041313;239510065;1468752
Jacobs;H127;24;42;28877449;31947993;3070544
Jacobs;H127;24;25;39603557;41143981;1540424
Jacobs;H128;2;31;4431496;5940814;1509318
Jacobs;H128;2;17;21789864;22493681;703817
Jacobs;H128;2;42;31712060;34096217;2384157
Jacobs;H128;2;18;49220327;49993837;773510
Jacobs;H128;2;142;52266474;59306755;7040281
Jacobs;H128;2;29;66730561;68326509;1595948
Jacobs;H128;2;204;69626926;80904183;11277257
Jacobs;H128;2;32;86266274;87906063;1639789
Jacobs;H128;2;18;101030254;101709271;679017
Jacobs;H128;2;15;110083416;110941391;857975
Jacobs;H128;2;21;121796989;123494681;1697692
Jacobs;H128;2;35;133272817;135337045;2064228
Jacobs;H128;2;23;168719169;170000512;1281343
Jacobs;H128;2;23;215994089;218592494;2598405
Jacobs;H128;2;41;219357404;221711968;2354564
Jacobs;H128;2;99;223876023;229097219;5221196
Jacobs;H128;2;28;230439460;232022650;1583190
Jacobs;H128;2;44;238041313;240409281;2367968
Jacobs;H128;2;15;241839716;242738945;899229
Jacobs;H128;24;26;4000350;5785403;1785053
Jacobs;H128;24;17;15762894;17133716;1370822
Jacobs;H128;24;84;25107237;31359697;6252460
Jacobs;H128;24;17;33879086;35216176;1337090
Jacobs;H129;2;15;4080987;4670884;589897
Jacobs;H129;2;198;33980393;46294279;12313886
Jacobs;H129;2;16;52327990;53043790;715800
Jacobs;H129;2;19;53986551;54687816;701265
Jacobs;H129;2;17;56446750;57307599;860849
Jacobs;H129;2;1240;75745623;147996276;72250653
Jacobs;H129;2;369;148213917;169169208;20955291
Jacobs;H129;2;16;178388511;179521559;1133048
Jacobs;H129;2;74;181751292;186224877;4473585
Jacobs;H129;2;17;198875303;199681176;805873
Jacobs;H129;2;18;215443702;217457102;2013400
Jacobs;H129;2;391;226508293;248799264;22290971
Jacobs;H129;24;20;11076801;12558998;1482197
Jacobs;H129;24;16;16041579;17253902;1212323
Jacobs;H129;24;54;19347886;24060526;4712640
Jacobs;H130;2;41;945715;2991783;2046068
Jacobs;H130;2;86;54135888;58258740;4122852
Jacobs;H130;2;21;65402955;66608553;1205598
Jacobs;H130;2;27;66858417;68326509;1468092
Jacobs;H130;2;32;75644823;77328509;1683686
Jacobs;H130;2;36;79183271;80967126;1783855
Jacobs;H130;2;101;82290592;88172646;5882054
Jacobs;H130;2;18;101030254;101709271;679017
Jacobs;H130;2;15;110083416;110941391;857975
Jacobs;H130;2;21;121796989;123494681;1697692
Jacobs;H130;2;35;133272817;135337045;2064228
Jacobs;H130;2;23;142709866;144170136;1460270
Jacobs;H130;2;25;162492078;163845372;1353294
Jacobs;H130;2;18;165399749;166276060;876311
Jacobs;H130;2;101;170563260;176450447;5887187
Jacobs;H130;2;16;198155571;198824819;669248
Jacobs;H130;2;22;211512445;212806608;1294163
Jacobs;H130;2;24;213674776;215641893;1967117
Jacobs;H130;2;60;217719922;221624187;3904265
Jacobs;H130;2;42;221940916;224027318;2086402
Jacobs;H130;2;84;225936196;230439460;4503264
Jacobs;H130;24;17;15762894;17133716;1370822
Jacobs;H130;24;42;28877449;31947993;3070544
Jacobs;H130;24;29;39603557;42027686;2424129
Jacobs;H131;2;31;1606489;2991783;1385294
Jacobs;H131;2;20;10206141;10967299;761158
Jacobs;H131;2;57;31362675;34615665;3252990
Jacobs;H131;2;16;41262244;42499181;1236937
Jacobs;H131;2;21;44461037;45493819;1032782
Jacobs;H131;2;16;64542824;65324896;782072
Jacobs;H131;2;18;70721438;71739429;1017991
Jacobs;H131;2;15;73109758;73839087;729329
Jacobs;H131;2;15;121734938;123048197;1313259
Jacobs;H131;2;28;124262151;125383356;1121205
Jacobs;H131;2;39;138618372;140560157;1941785
Jacobs;H131;2;21;168719169;169929278;1210109
Jacobs;H131;2;22;177580706;178764936;1184230
Jacobs;H131;2;39;184760567;187259707;2499140
Jacobs;H131;2;61;193151043;197093416;3942373
Jacobs;H131;2;39;199432096;201797379;2365283
Jacobs;H131;2;18;205244432;206276753;1032321
Jacobs;H131;2;50;211512445;215251657;3739212
Jacobs;H131;2;52;215844761;220852308;5007547
Jacobs;H131;2;16;223012717;223762044;749327
Jacobs;H131;2;31;241748973;243490742;1741769
Jacobs;H131;2;31;246918062;248799264;1881202
Jacobs;H131;24;18;12496861;13767641;1270780
Jacobs;H131;24;19;16041579;17460873;1419294
Jacobs;H131;24;15;20909487;22222030;1312543
Jacobs;H131;24;28;32681863;34176391;1494528
Jacobs;H131;24;26;36250095;38125663;1875568
Jacobs;H132;2;248;26664802;42499181;15834379
Jacobs;H132;2;413;54135888;76732322;22596434
Jacobs;H132;2;16;79000514;80032995;1032481
Jacobs;H132;2;42;84054194;86582074;2527880
Jacobs;H132;2;18;108309773;109132360;822587
Jacobs;H132;2;17;110606314;112190964;1584650
Jacobs;H132;2;36;114106580;116350674;2244094
Jacobs;H132;2;16;116635922;117464089;828167
Jacobs;H132;2;23;122001925;123573014;1571089
Jacobs;H132;2;41;126622908;128843993;2221085
Jacobs;H132;2;23;130368989;131682707;1313718
Jacobs;H132;2;32;132635669;134244380;1608711
Jacobs;H132;2;16;134667278;135446006;778728
Jacobs;H132;2;24;148986290;150059057;1072767
Jacobs;H132;2;31;162689295;164308657;1619362
Jacobs;H132;2;34;204702992;206427786;1724794
Jacobs;H132;2;98;207548922;212806608;5257686
Jacobs;H132;2;37;213505877;217457102;3951225
Jacobs;H132;2;19;218058406;219468105;1409699
Jacobs;H132;2;17;219847222;220955491;1108269
Jacobs;H132;2;16;243365308;244608420;1243112
Jacobs;H132;24;43;96467;3580800;3484333
Jacobs;H132;24;19;15551549;16957079;1405530
Jacobs;H132;24;17;19946691;21392558;1445867
Jacobs;H132;24;16;31556086;32390507;834421
Jacobs;H133;2;58;158066;3603417;3445351
Jacobs;H133;2;16;10266961;10887825;620864
Jacobs;H133;2;186;15181363;24861755;9680392
Jacobs;H133;2;71;45320994;49646230;4325236
Jacobs;H133;2;34;51720147;53366034;1645887
Jacobs;H133;2;15;55136707;55995982;859275
Jacobs;H133;2;60;68216266;71739429;3523163
Jacobs;H133;2;15;73109758;73839087;729329
Jacobs;H133;2;63;95385937;99487592;4101655
Jacobs;H133;2;17;110875234;112943535;2068301
Jacobs;H133;2;22;114411448;115784285;1372837
Jacobs;H133;2;17;115912934;117115355;1202421
Jacobs;H133;2;41;133272817;135576714;2303897
Jacobs;H133;2;71;140104951;144021471;3916520
Jacobs;H133;2;44;147210213;149666645;2456432
Jacobs;H133;2;224;179799000;193045812;13246812
Jacobs;H133;2;55;193433380;197093416;3660036
Jacobs;H133;2;134;207040648;215251657;8211009
Jacobs;H133;2;36;215844761;219774612;3929851
Jacobs;H133;2;20;220083076;221153389;1070313
Jacobs;H133;2;17;238831242;239616700;785458
Jacobs;H133;24;25;11007102;12952274;1945172
Jacobs;H133;24;72;27620251;32495625;4875374
Jacobs;H133;24;20;33313461;34176391;862930
Jacobs;H133;24;74;36250095;42027686;5777591
Jacobs;H134;2;28;25481746;27284017;1802271
Jacobs;H134;2;16;52327990;53043790;715800
Jacobs;H134;2;19;53986551;54687816;701265
Jacobs;H134;2;105;70548455;76783372;6234917
Jacobs;H134;2;19;80262318;80967126;704808
Jacobs;H134;2;17;94981400;96022899;1041499
Jacobs;H134;2;18;108309773;109132360;822587
Jacobs;H134;2;17;110606314;112190964;1584650
Jacobs;H134;2;25;114883685;116350674;1466989
Jacobs;H134;2;16;116635922;117464089;828167
Jacobs;H134;2;23;122001925;123573014;1571089
Jacobs;H134;2;88;128625705;133040292;4414587
Jacobs;H134;2;28;170856163;172424726;1568563
Jacobs;H134;2;605;179348624;215098553;35749929
Jacobs;H134;2;18;215443702;217457102;2013400
Jacobs;H134;2;17;219847222;220955491;1108269
Jacobs;H134;2;31;238831242;240477448;1646206
Jacobs;H134;2;16;246121938;246737445;615507
Jacobs;H134;24;23;203039;2191707;1988668
Jacobs;H134;24;19;15865169;17307132;1441963
Jacobs;H134;24;35;26493858;29197813;2703955
Jacobs;H135;2;15;24966147;25765503;799356
Jacobs;H135;2;51;54135888;56751008;2615120
Jacobs;H135;2;43;80262318;82192970;1930652
Jacobs;H135;2;25;84141589;85875802;1734213
Jacobs;H135;2;18;100934715;101600940;666225
Jacobs;H135;2;20;108235636;109132360;896724
Jacobs;H135;2;19;116203332;117314510;1111178
Jacobs;H135;2;27;122001925;123740047;1738122
Jacobs;H135;2;15;135590631;136512593;921962
Jacobs;H135;2;48;147210213;149923043;2712830
Jacobs;H135;2;71;150948753;155337073;4388320
Jacobs;H135;2;47;172699752;175418941;2719189
Jacobs;H135;2;117;199432096;205572258;6140162
Jacobs;H135;2;15;236541718;237613535;1071817
Jacobs;H135;24;24;5232180;6526499;1294319
Jacobs;H135;24;74;11076801;16147749;5070948
Jacobs;H135;24;77;18056244;24629625;6573381
Jacobs;H135;24;65;31821433;36076909;4255476
Jacobs;H136;2;1099;158066;62482737;62324671
Jacobs;H136;2;18;91276899;92162531;885632
Jacobs;H136;2;49;99302002;101684673;2382671
Jacobs;H136;2;20;108235636;109132360;896724
Jacobs;H136;2;24;113897647;115665643;1767996
Jacobs;H136;2;23;122001925;123573014;1571089
Jacobs;H136;2;15;135636519;136565040;928521
Jacobs;H136;2;71;150948753;155337073;4388320
Jacobs;H136;2;16;178388511;179521559;1133048
Jacobs;H136;2;75;181751292;186306661;4555369
Jacobs;H136;2;17;198875303;199681176;805873
Jacobs;H136;2;16;215443702;216807667;1363965
Jacobs;H136;2;84;244066362;248799264;4732902
Jacobs;H136;24;20;2043961;3507572;1463611
Jacobs;H137;2;52;1606489;4166902;2560413
Jacobs;H137;2;27;25481746;27218367;1736621
Jacobs;H137;2;16;52327990;53043790;715800
Jacobs;H137;2;19;53986551;54687816;701265
Jacobs;H137;2;105;70548455;76783372;6234917
Jacobs;H137;2;19;80262318;80967126;704808
Jacobs;H137;2;31;82557618;84580673;2023055
Jacobs;H137;2;17;94981400;96022899;1041499
Jacobs;H137;2;18;108309773;109132360;822587
Jacobs;H137;2;17;110606314;112190964;1584650
Jacobs;H137;2;25;114883685;116350674;1466989
Jacobs;H137;2;16;116635922;117464089;828167
Jacobs;H137;2;23;122001925;123573014;1571089
Jacobs;H137;2;88;128625705;133040292;4414587
Jacobs;H137;2;22;136842711;138081646;1238935
Jacobs;H137;2;18;139718962;140468415;749453
Jacobs;H137;2;41;141604180;144021471;2417291
Jacobs;H137;2;139;155064316;163070840;8006524
Jacobs;H137;2;609;182923305;220103004;37179699
Jacobs;H137;2;36;225783164;227781732;1998568
Jacobs;H137;2;16;231543005;232414241;871236
Jacobs;H137;2;16;232591652;233623788;1032136
Jacobs;H137;2;31;241649475;243449101;1799626
Jacobs;H137;2;26;246116878;247245173;1128295
Jacobs;H137;24;74;26493858;31947993;5454135
Jacobs;H138;2;70;1606489;4835268;3228779
Jacobs;H138;2;529;24756265;56751008;31994743
Jacobs;H138;2;18;92454972;93425673;970701
Jacobs;H138;2;21;121796989;123494681;1697692
Jacobs;H138;2;58;127306102;130606432;3300330
Jacobs;H138;2;36;133272817;135391568;2118751
Jacobs;H138;2;15;139800218;140468415;668197
Jacobs;H138;2;24;141604180;142963793;1359613
Jacobs;H138;2;15;167511192;168264380;753188
Jacobs;H138;2;16;190574847;191319781;744934
Jacobs;H138;2;113;208020229;215098553;7078324
Jacobs;H138;2;16;215443702;216807667;1363965
Jacobs;H138;2;24;233775867;235184763;1408896
Jacobs;H138;2;18;239564082;240647987;1083905
Jacobs;H138;2;15;241371128;242316517;945389
Jacobs;H138;24;59;5593329;8842899;3249570
Jacobs;H138;24;15;34460565;35991517;1530952
Jacobs;H139;2;16;16264144;17033754;769610
Jacobs;H139;2;22;24524166;25481746;957580
Jacobs;H139;2;27;49602010;51384849;1782839
Jacobs;H139;2;16;64459393;65203824;744431
Jacobs;H139;2;21;65402955;66608553;1205598
Jacobs;H139;2;27;66858417;68326509;1468092
Jacobs;H139;2;22;72875158;74090507;1215349
Jacobs;H139;2;55;84054194;87222916;3168722
Jacobs;H139;2;18;101030254;101709271;679017
Jacobs;H139;2;15;110083416;110941391;857975
Jacobs;H139;2;21;121796989;123494681;1697692
Jacobs;H139;2;50;132635669;135337045;2701376
Jacobs;H139;2;26;149768329;151345671;1577342
Jacobs;H139;2;23;158290735;159916624;1625889
Jacobs;H139;2;15;164745318;165486783;741465
Jacobs;H139;2;70;187856073;191673164;3817091
Jacobs;H139;2;15;193197692;193999697;802005
Jacobs;H139;2;15;203751286;204502491;751205
Jacobs;H139;2;27;205244432;206821701;1577269
Jacobs;H139;2;22;211512445;212806608;1294163
Jacobs;H139;2;24;213674776;215641893;1967117
Jacobs;H139;2;60;217719922;221624187;3904265
Jacobs;H139;2;42;221940916;224027318;2086402
Jacobs;H139;2;84;225936196;230439460;4503264
Jacobs;H139;24;74;26493858;31947993;5454135
Jacobs;H140;2;23;9589549;10610698;1021149
Jacobs;H140;2;19;30485387;31353780;868393
Jacobs;H140;2;17;45092839;46163449;1070610
Jacobs;H140;2;31;46648569;49009193;2360624
Jacobs;H140;2;27;49602010;51384849;1782839
Jacobs;H140;2;16;64771512;65574894;803382
Jacobs;H140;2;29;67963504;69441272;1477768
Jacobs;H140;2;19;70664942;71739429;1074487
Jacobs;H140;2;15;73109758;73839087;729329
Jacobs;H140;2;167;75644823;84580673;8935850
Jacobs;H140;2;51;94981400;98156393;3174993
Jacobs;H140;2;381;102979198;126384559;23405361
Jacobs;H140;2;73;140622573;144672338;4049765
Jacobs;H140;2;22;211512445;212806608;1294163
Jacobs;H140;2;24;213674776;215641893;1967117
Jacobs;H140;2;107;217719922;224027318;6307396
Jacobs;H140;2;16;231543005;232414241;871236
Jacobs;H140;2;16;232591652;233623788;1032136
Jacobs;H140;2;23;247498052;248799264;1301212
Jacobs;H140;24;74;12129478;17307132;5177654
Jacobs;H141;2;15;4080987;4670884;589897
Jacobs;H141;2;29;6349125;8180894;1831769
Jacobs;H141;2;18;10649928;11555842;905914
Jacobs;H141;2;44;12597644;14837808;2240164
Jacobs;H141;2;19;16487040;17482057;995017
Jacobs;H141;2;49;26664802;30051860;3387058
Jacobs;H141;2;19;30485387;31353780;868393
Jacobs;H141;2;17;45092839;46163449;1070610
Jacobs;H141;2;31;46648569;49009193;2360624
Jacobs;H141;2;27;49602010;51384849;1782839
Jacobs;H141;2;28;55160910;56751008;1590098
Jacobs;H141;2;22;72875158;74090507;1215349
Jacobs;H141;2;692;87077242;128972285;41895043
Jacobs;H141;2;15;130009715;130831021;821306
Jacobs;H141;2;35;133272817;135337045;2064228
Jacobs;H141;2;18;150249776;151345671;1095895
Jacobs;H141;2;68;152160860;156230655;4069795
Jacobs;H141;2;22;176405730;177951142;1545412
Jacobs;H141;2;199;187856073;199225518;11369445
Jacobs;H141;2;45;238041313;240477448;2436135
Jacobs;H141;2;23;247498052;248799264;1301212
Jacobs;H141;24;15;8556294;9268996;712702
Jacobs;H141;24;45;28877449;32163368;3285919
Jacobs;H142;2;70;1606489;4835268;3228779
Jacobs;H142;2;30;24756265;26438460;1682195
Jacobs;H142;2;22;29409606;30698479;1288873
Jacobs;H142;2;105;70548455;76783372;6234917
Jacobs;H142;2;19;80262318;80967126;704808
Jacobs;H142;2;16;94561848;95129267;567419
Jacobs;H142;2;17;103466624;104364614;897990
Jacobs;H142;2;30;121607287;123644129;2036842
Jacobs;H142;2;23;130368989;131682707;1313718
Jacobs;H142;2;29;139427894;140785606;1357712
Jacobs;H142;2;30;149553962;151345671;1791709
Jacobs;H142;2;23;168719169;170000512;1281343
Jacobs;H142;2;340;172616581;193433380;20816799
Jacobs;H142;2;113;208020229;215098553;7078324
Jacobs;H142;2;16;215443702;216807667;1363965
Jacobs;H142;2;31;238831242;240477448;1646206
Jacobs;H142;2;26;246116878;247245173;1128295
Jacobs;H142;24;19;15865169;17307132;1441963
Jacobs;H142;24;35;26493858;29197813;2703955
Jacobs;H143;2;16;10266961;10887825;620864
Jacobs;H143;2;22;19128677;20209570;1080893
Jacobs;H143;2;38;25939009;28578328;2639319
Jacobs;H143;2;19;65876876;67012655;1135779
Jacobs;H143;2;37;67534697;69441272;1906575
Jacobs;H143;2;19;70664942;71739429;1074487
Jacobs;H143;2;191;116350674;126926047;10575373
Jacobs;H143;2;60;129421996;132550706;3128710
Jacobs;H143;2;34;142709866;144672338;1962472
Jacobs;H143;2;276;157252102;173034908;15782806
Jacobs;H143;2;27;180080977;182097199;2016222
Jacobs;H143;2;17;199076879;199942549;865670
Jacobs;H143;2;32;215443702;218309332;2865630
Jacobs;H143;2;54;219933911;222800960;2867049
Jacobs;H143;2;16;223012717;223762044;749327
Jacobs;H143;2;16;238831242;239564082;732840
Jacobs;H143;24;19;15865169;17307132;1441963
Jacobs;H143;24;35;26493858;29197813;2703955
Jacobs;H144;2;53;2278905;4670884;2391979
Jacobs;H144;2;16;18903649;19654697;751048
Jacobs;H144;2;15;24966147;25765503;799356
Jacobs;H144;2;51;54135888;56751008;2615120
Jacobs;H144;2;95;75626143;80421373;4795230
Jacobs;H144;2;76;85589367;89818428;4229061
Jacobs;H144;2;17;103407822;104281644;873822
Jacobs;H144;2;30;121607287;123644129;2036842
Jacobs;H144;2;40;125273857;127088467;1814610
Jacobs;H144;2;74;129353026;133040292;3687266
Jacobs;H144;2;54;143864562;146856560;2991998
Jacobs;H144;2;139;155064316;163070840;8006524
Jacobs;H144;2;23;168719169;170000512;1281343
Jacobs;H144;2;48;215594803;220103004;4508201
Jacobs;H144;2;16;223012717;223762044;749327
Jacobs;H144;2;15;230006689;230823473;816784
Jacobs;H144;2;138;231069887;238899861;7829974
Jacobs;H144;24;43;96467;3580800;3484333
Jacobs;H144;24;15;16077497;17253902;1176405
Jacobs;H145;2;45;2278905;4351718;2072813
Jacobs;H145;2;35;13473852;15141339;1667487
Jacobs;H145;2;64;16172689;19404154;3231465
Jacobs;H145;2;40;46219946;49009193;2789247
Jacobs;H145;2;31;60131740;61875935;1744195
Jacobs;H145;2;73;62820094;66608553;3788459
Jacobs;H145;2;34;69626926;71739429;2112503
Jacobs;H145;2;15;73109758;73839087;729329
Jacobs;H145;2;25;87257501;88447935;1190434
Jacobs;H145;2;24;108309773;109487038;1177265
Jacobs;H145;2;21;116265153;117413762;1148609
Jacobs;H145;2;15;121734938;123048197;1313259
Jacobs;H145;2;64;124133864;127070041;2936177
Jacobs;H145;2;23;127495017;128843993;1348976
Jacobs;H145;2;51;132635669;135391568;2755899
Jacobs;H145;2;25;136654969;138081646;1426677
Jacobs;H145;2;53;140158515;142963793;2805278
Jacobs;H145;2;15;161998965;162572509;573544
Jacobs;H145;2;23;215251657;217457102;2205445
Jacobs;H145;2;20;236285593;237613535;1327942
Jacobs;H145;24;17;96467;1377045;1280578
Jacobs;H146;2;45;2278905;4351718;2072813
Jacobs;H146;2;71;5011935;9266747;4254812
Jacobs;H146;2;258;16172689;30785949;14613260
Jacobs;H146;2;30;46648569;48930164;2281595
Jacobs;H146;2;83;50949347;55415073;4465726
Jacobs;H146;2;15;73109758;73839087;729329
Jacobs;H146;2;80;84705740;88789712;4083972
Jacobs;H146;2;83;95385937;100774009;5388072
Jacobs;H146;2;15;121734938;123048197;1313259
Jacobs;H146;2;51;124133864;126384559;2250695
Jacobs;H146;2;51;132635669;135391568;2755899
Jacobs;H146;2;22;136654969;137832529;1177560
Jacobs;H146;2;251;157462596;171889296;14426700
Jacobs;H146;2;17;172616581;173532404;915823
Jacobs;H146;2;56;184565642;188204145;3638503
Jacobs;H146;2;109;193433380;199942549;6509169
Jacobs;H146;2;134;207040648;215251657;8211009
Jacobs;H146;2;52;215844761;220852308;5007547
Jacobs;H146;2;35;246737445;248799264;2061819
Jacobs;H146;24;62;96467;5075204;4978737
Jacobs;H146;24;109;5593329;12952274;7358945
Jacobs;H147;2;271;158066;15141339;14983273
Jacobs;H147;2;21;16416165;17482057;1065892
Jacobs;H147;2;60;36971592;41162381;4190789
Jacobs;H147;2;18;49220327;49993837;773510
Jacobs;H147;2;23;53528684;54596587;1067903
Jacobs;H147;2;1344;55160910;132550706;77389796
Jacobs;H147;2;34;142709866;144672338;1962472
Jacobs;H147;2;75;167111471;171362036;4250565
Jacobs;H147;2;15;176695897;177580706;884809
Jacobs;H147;2;17;199076879;199942549;865670
Jacobs;H147;2;316;201140943;220955491;19814548
Jacobs;H147;2;15;241839716;242738945;899229
Jacobs;H147;2;89;243537018;248799264;5262246
Jacobs;H147;24;25;15100676;16811910;1711234
Jacobs;H147;24;16;20189283;21460746;1271463
Jacobs;H147;24;40;28877449;31899729;3022280
Jacobs;H147;24;28;32495625;33953578;1457953
Jacobs;H148;2;15;4080987;4670884;589897
Jacobs;H148;2;50;12597644;15141339;2543695
Jacobs;H148;2;21;16416165;17482057;1065892
Jacobs;H148;2;685;34584226;73839087;39254861
Jacobs;H148;2;55;84054194;87222916;3168722
Jacobs;H148;2;24;117369115;119081713;1712598
Jacobs;H148;2;21;121796989;123494681;1697692
Jacobs;H148;2;35;133272817;135337045;2064228
Jacobs;H148;2;62;148581376;151888029;3306653
Jacobs;H148;2;108;170058634;176450447;6391813
Jacobs;H148;2;15;198176953;198824819;647866
Jacobs;H148;2;22;211512445;212806608;1294163
Jacobs;H148;2;24;213674776;215641893;1967117
Jacobs;H148;2;28;215844761;219015064;3170303
Jacobs;H148;2;17;219847222;220955491;1108269
Jacobs;H148;2;15;236449805;237488816;1039011
Jacobs;H148;2;15;244129054;244947713;818659
Jacobs;H148;24;17;15762894;17133716;1370822
Jacobs;H148;24;43;28877449;31953567;3076118
Jacobs;H148;24;25;39603557;41143981;1540424
Jacobs;H149;2;109;158066;6092514;5934448
Jacobs;H149;2;31;13307050;14837808;1530758
Jacobs;H149;2;21;16416165;17482057;1065892
Jacobs;H149;2;49;26664802;30051860;3387058
Jacobs;H149;2;86;40790032;46146229;5356197
Jacobs;H149;2;15;49484087;50080258;596171
Jacobs;H149;2;91;58791324;63635636;4844312
Jacobs;H149;2;19;65876876;67012655;1135779
Jacobs;H149;2;37;67534697;69441272;1906575
Jacobs;H149;2;19;70664942;71739429;1074487
Jacobs;H149;2;15;73109758;73839087;729329
Jacobs;H149;2;43;80262318;82192970;1930652
Jacobs;H149;2;17;103407822;104281644;873822
Jacobs;H149;2;39;131397735;133040292;1642557
Jacobs;H149;2;40;140827873;142963793;2135920
Jacobs;H149;2;15;198176953;198824819;647866
Jacobs;H149;2;16;215443702;216807667;1363965
Jacobs;H149;2;15;244129054;244947713;818659
Jacobs;H149;24;26;7967370;9268996;1301626
Jacobs;H149;24;21;15324479;16892562;1568083
Jacobs;H150;2;86;29409606;34303557;4893951
Jacobs;H150;2;86;40790032;46146229;5356197
Jacobs;H150;2;15;49484087;50080258;596171
Jacobs;H150;2;25;58791324;60044110;1252786
Jacobs;H150;2;19;65876876;67012655;1135779
Jacobs;H150;2;37;67534697;69441272;1906575
Jacobs;H150;2;19;70664942;71739429;1074487
Jacobs;H150;2;15;73109758;73839087;729329
Jacobs;H150;2;43;80262318;82192970;1930652
Jacobs;H150;2;17;94981400;96022899;1041499
Jacobs;H150;2;22;108072803;109132360;1059557
Jacobs;H150;2;17;110606314;112190964;1584650
Jacobs;H150;2;25;114883685;116350674;1466989
Jacobs;H150;2;16;116635922;117464089;828167
Jacobs;H150;2;23;122001925;123573014;1571089
Jacobs;H150;2;88;128625705;133040292;4414587
Jacobs;H150;2;40;140827873;142963793;2135920
Jacobs;H150;2;15;198176953;198824819;647866
Jacobs;H150;2;16;215443702;216807667;1363965
Jacobs;H150;2;16;231543005;232414241;871236
Jacobs;H150;2;16;232591652;233623788;1032136
Jacobs;H150;2;31;241649475;243449101;1799626
Jacobs;H150;2;26;246116878;247245173;1128295
Jacobs;H150;24;21;12496861;13980455;1483594
Jacobs;H150;24;21;15324479;16892562;1568083
Jacobs;H150;24;18;34460565;36160755;1700190
Jacobs;H151;2;61;11476553;14837808;3361255
Jacobs;H151;2;251;16622194;30785949;14163755
Jacobs;H151;2;47;40205877;43558237;3352360
Jacobs;H151;2;30;46648569;48930164;2281595
Jacobs;H151;2;34;51720147;53366034;1645887
Jacobs;H151;2;18;57559602;58198123;638521
Jacobs;H151;2;16;64771512;65574894;803382
Jacobs;H151;2;19;70664942;71739429;1074487
Jacobs;H151;2;15;73109758;73839087;729329
Jacobs;H151;2;17;110875234;112943535;2068301
Jacobs;H151;2;22;114411448;115784285;1372837
Jacobs;H151;2;17;115912934;117115355;1202421
Jacobs;H151;2;52;132635669;135446006;2810337
Jacobs;H151;2;25;136654969;138081646;1426677
Jacobs;H151;2;53;140158515;142963793;2805278
Jacobs;H151;2;44;147210213;149666645;2456432
Jacobs;H151;2;224;179799000;193045812;13246812
Jacobs;H151;2;50;196669044;199225518;2556474
Jacobs;H151;2;19;210948623;211735126;786503
Jacobs;H151;2;16;223812677;224444800;632123
Jacobs;H151;2;15;227373381;228130504;757123
Jacobs;H151;24;26;8379806;9942134;1562328
Jacobs;H151;24;18;15637488;17133716;1496228
Jacobs;H151;24;47;23209530;26681408;3471878
Jacobs;H152;2;27;45320994;47352919;2031925
Jacobs;H152;2;51;54135888;56751008;2615120
Jacobs;H152;2;19;70664942;71739429;1074487
Jacobs;H152;2;15;73109758;73839087;729329
Jacobs;H152;2;74;80701449;84891847;4190398
Jacobs;H152;2;20;86266274;87222916;956642
Jacobs;H152;2;177;117369115;127070041;9700926
Jacobs;H152;2;35;133272817;135337045;2064228
Jacobs;H152;2;37;162689295;164594319;1905024
Jacobs;H152;2;17;171889296;172616581;727285
Jacobs;H152;2;15;175346551;176135485;788934
Jacobs;H152;2;19;218058406;219468105;1409699
Jacobs;H152;2;17;219847222;220955491;1108269
Jacobs;H152;2;49;240647987;243449101;2801114
Jacobs;H152;2;16;247955981;248799264;843283
Jacobs;H152;24;17;15762894;17133716;1370822
Jacobs;H152;24;47;17514108;21460746;3946638
Jacobs;H152;24;35;28877449;31359697;2482248
Jacobs;H152;24;17;34345815;36036418;1690603
Jacobs;H153;2;104;16622194;21928040;5305846
Jacobs;H153;2;28;22809937;24157644;1347707
Jacobs;H153;2;20;24756265;25765503;1009238
Jacobs;H153;2;19;39327845;40350901;1023056
Jacobs;H153;2;30;46648569;48930164;2281595
Jacobs;H153;2;16;52327990;53043790;715800
Jacobs;H153;2;16;64771512;65574894;803382
Jacobs;H153;2;20;73508928;74700075;1191147
Jacobs;H153;2;153;77170481;85508894;8338413
Jacobs;H153;2;42;98008059;100774009;2765950
Jacobs;H153;2;47;107035638;109132360;2096722
Jacobs;H153;2;21;121796989;123494681;1697692
Jacobs;H153;2;119;131649580;137832529;6182949
Jacobs;H153;2;34;142709866;144672338;1962472
Jacobs;H153;2;68;152160860;156230655;4069795
Jacobs;H153;2;17;173034908;173910913;876005
Jacobs;H153;2;56;184565642;188204145;3638503
Jacobs;H153;2;19;210948623;211735126;786503
Jacobs;H153;24;42;96467;3507572;3411105
Jacobs;H153;24;52;16077497;20406106;4328609
Jacobs;H154;2;70;1606489;4835268;3228779
Jacobs;H154;2;29;14359717;15741288;1381571
Jacobs;H154;2;24;16264144;17482057;1217913
Jacobs;H154;2;49;26664802;30051860;3387058
Jacobs;H154;2;70;30463448;34303557;3840109
Jacobs;H154;2;86;40790032;46146229;5356197
Jacobs;H154;2;16;52327990;53043790;715800
Jacobs;H154;2;19;53986551;54687816;701265
Jacobs;H154;2;105;70548455;76783372;6234917
Jacobs;H154;2;19;80262318;80967126;704808
Jacobs;H154;2;16;101134453;101709271;574818
Jacobs;H154;2;21;121796989;123494681;1697692
Jacobs;H154;2;58;127306102;130606432;3300330
Jacobs;H154;2;53;131596312;134094336;2498024
Jacobs;H154;2;18;139718962;140468415;749453
Jacobs;H154;2;41;141604180;144021471;2417291
Jacobs;H154;2;139;155064316;163070840;8006524
Jacobs;H154;2;139;186306661;193999697;7693036
Jacobs;H154;2;49;199432096;202249334;2817238
Jacobs;H154;2;33;215098553;217925961;2827408
Jacobs;H154;2;17;219847222;220955491;1108269
Jacobs;H154;2;19;239510065;240647987;1137922
Jacobs;H154;24;19;15865169;17307132;1441963
Jacobs;H154;24;68;26493858;31556086;5062228
Jacobs;H155;2;70;1606489;4835268;3228779
Jacobs;H155;2;27;25481746;27218367;1736621
Jacobs;H155;2;16;52327990;53043790;715800
Jacobs;H155;2;19;53986551;54687816;701265
Jacobs;H155;2;97;58791324;63837976;5046652
Jacobs;H155;2;221;65876876;78426196;12549320
Jacobs;H155;2;15;81452694;82013700;561006
Jacobs;H155;2;16;101134453;101709271;574818
Jacobs;H155;2;21;121796989;123494681;1697692
Jacobs;H155;2;58;127306102;130606432;3300330
Jacobs;H155;2;16;130818423;131682707;864284
Jacobs;H155;2;40;162492078;164594319;2102241
Jacobs;H155;2;17;171889296;172616581;727285
Jacobs;H155;2;37;179348624;182039142;2690518
Jacobs;H155;2;16;190574847;191319781;744934
Jacobs;H155;2;46;208020229;210557713;2537484
Jacobs;H155;2;18;215443702;217457102;2013400
Jacobs;H155;2;31;217719922;220103004;2383082
Jacobs;H155;2;16;231543005;232414241;871236
Jacobs;H155;2;16;232591652;233623788;1032136
Jacobs;H155;2;31;241649475;243449101;1799626
Jacobs;H155;2;26;246116878;247245173;1128295
Jacobs;H155;24;19;15865169;17307132;1441963
Jacobs;H155;24;35;26493858;29197813;2703955
